"Dato";"Valør";"Tekst";"";"Beløb";"Saldo";"Egen bilagsreference"
"09.01.2025";"09.01.2025";"viabill";"";"-13.208,39";"805.994,07";""
"09.01.2025";"09.01.2025";"OK Beniz";"";"-3.547,71";"802.446,36";""
"09.01.2025";"09.01.2025";"Telenor";"";"-4.399,00";"798.047,36";""
"09.01.2025";"09.01.2025";"Collectia";"";"-1.833,00";"796.214,36";""
"09.01.2025";"09.01.2025";"Larsen og Jakobsen Fakturanr. 15090";"";"-9.875,00";"786.339,36";""
"09.01.2025";"09.01.2025";"europark";"";"-975,00";"785.364,36";""
"09.01.2025";"09.01.2025";"EuroIncasso";"";"-1.789,99";"783.574,37";""
"09.01.2025";"09.01.2025";"MCD 00652 BILKA TILST";"";"-333,65";"783.240,72";""
"09.01.2025";"09.01.2025";"Telenor restbetaling";"";"-6.810,56";"776.430,16";""
"09.01.2025";"09.01.2025";"TravelLink";"";"-4.395,82";"772.034,34";""
"10.01.2025";"10.01.2025";"BS AURA A/S - FIBER";"";"-299,00";"771.735,34";""
"10.01.2025";"10.01.2025";"MCD 00654 CIRCLE K TILST";"";"-25,00";"771.710,34";""
"10.01.2025";"10.01.2025";"MCD 00655 CIRCLE K TILST";"";"-67,00";"771.643,34";""
"10.01.2025";"10.01.2025";"MCD 00653 CIRCLE K TILST";"";"-118,00";"771.525,34";""
"13.01.2025";"13.01.2025";"Booking";"";"-2.500,00";"769.025,34";""
"13.01.2025";"13.01.2025";"MCD 00656 Q8 Låsby 8205";"";"-69,95";"768.955,39";""
"13.01.2025";"13.01.2025";"MCD 00657 Q8 Låsby 8205";"";"-69,95";"768.885,44";""
"13.01.2025";"13.01.2025";"MCD 00658 CIRCLE K TILST";"";"-117,00";"768.768,44";""
"13.01.2025";"13.01.2025";"MCD 00660 CIRCLE K TILST";"";"-1,00";"768.767,44";""
"13.01.2025";"13.01.2025";"MCD 00659 CIRCLE K TILST";"";"-322,00";"768.445,44";""
"13.01.2025";"13.01.2025";"MCD 00661 MCDONALDS HURGHADA 2 500,00 EGP kurs: 14,460000";"";"-74,04";"768.371,40";""
"14.01.2025";"14.01.2025";"LS 28924 VISMA E-CONOMIC A/S";"";"-1.308,75";"767.062,65";""
"14.01.2025";"14.01.2025";"MCD 00664 IMO Tilst";"";"-259,00";"766.803,65";""
"14.01.2025";"14.01.2025";"MCD 00663 YouSee Aarhus Nord 796";"";"-608,00";"766.195,65";""
"14.01.2025";"14.01.2025";"MCD 00662 AXEL KAUFMANN A";"";"-2.999,00";"763.196,65";""
"14.01.2025";"14.01.2025";"Overførsel";"";"-31,25";"763.165,40";""
"15.01.2025";"15.01.2025";"MCD 00667 SINTRA 15,60 USD kurs: 733,141000";"";"-117,11";"763.048,29";""
"15.01.2025";"15.01.2025";"MCD 00665 HERSKIND BRUGS";"";"-221,25";"762.827,04";""
"15.01.2025";"15.01.2025";"MCD 00666 Wolt";"";"-448,25";"762.378,79";""
"16.01.2025";"16.01.2025";"MCD 00668 THANSEN GRUPPEN";"";"-707,95";"761.670,84";""
"17.01.2025";"17.01.2025";"MCD 00671 Wolt";"";"-253,79";"761.417,05";""
"17.01.2025";"17.01.2025";"MCD 00670 Wolt";"";"-396,65";"761.020,40";""
"17.01.2025";"17.01.2025";"MCD 00669 CIRCLE K TILST";"";"-672,54";"760.347,86";""
"20.01.2025";"20.01.2025";"MCD 00672 7-ELEVEN BUTIK";"";"-92,00";"760.255,86";""
"22.01.2025";"22.01.2025";"LS 38393 DANFOODS APS";"";"-484,63";"759.771,23";""
"24.01.2025";"24.01.2025";"LS 38393 DANFOODS APS";"";"-166,18";"759.605,05";""
"28.01.2025";"28.01.2025";"MCD 00673 OK DB Hoejen";"";"-767,46";"758.837,59";""
"31.01.2025";"31.01.2025";"Kundegebyr";"";"-200,00";"758.637,59";""
"03.02.2025";"03.02.2025";"SAMSØ FESTIVAL FORENING";"";"-1.000,00";"757.637,59";""
"03.02.2025";"03.02.2025";"Johs. Sørensen & Sønner Århus A/";"";"-1.911,98";"755.725,61";""
"03.02.2025";"03.02.2025";"Collectia - sagsnr 5040385";"";"-1.805,14";"753.920,47";""
"03.02.2025";"03.02.2025";"FerieKonto - SE-nr.: 44 37 19 01";"";"-2.440,34";"751.480,13";""
"03.02.2025";"03.02.2025";"Ref.nr. 44 37 19 01/SB";"";"-650,03";"750.830,10";""
"03.02.2025";"03.02.2025";"DE28303:Periode";"";"-23,83";"750.806,27";""
"03.02.2025";"03.02.2025";"JKS 2369791";"";"-227,56";"750.578,71";""
"03.02.2025";"03.02.2025";"BS TELENOR A/S";"";"-165,66";"750.413,05";""
"04.02.2025";"04.02.2025";"LS 38393 DANFOODS APS";"";"-1.242,16";"749.170,89";""
"06.02.2025";"06.02.2025";"Molslinje";"";"-649,00";"748.521,89";""
"07.02.2025";"07.02.2025";"MCD 00674 CIRCLE K ARHUSVEJ, RAN";"";"-400,65";"748.121,24";""
"07.02.2025";"07.02.2025";"Mobilepay";"";"-2.500,00";"745.621,24";""
"10.02.2025";"10.02.2025";"MCD 00677 ALI BAGERI";"";"-165,00";"745.456,24";""
"10.02.2025";"10.02.2025";"MCD 00675 CIRCLE K TILST";"";"-605,64";"744.850,60";""
"10.02.2025";"10.02.2025";"MCD 00676 DAGROFA S/ENGRO";"";"-1.059,12";"743.791,48";""
"10.02.2025";"10.02.2025";"MCD 00682 MCD VEJLE SYD";"";"-47,00";"743.744,48";""
"10.02.2025";"10.02.2025";"MCD 00679 Q8 Vissenbjerg 8102";"";"-416,00";"743.328,48";""
"10.02.2025";"10.02.2025";"MCD 00680 CIRCLE K TILST";"";"-506,53";"742.821,95";""
"10.02.2025";"10.02.2025";"MCD 00681 MCD VEJLE SYD";"";"-552,00";"742.269,95";""
"10.02.2025";"10.02.2025";"MCD 00678 Storebaeltsforbindelse";"";"-635,00";"741.634,95";""
"10.02.2025";"10.02.2025";"BS AURA A/S - FIBER";"";"-299,00";"741.335,95";""
"10.02.2025";"10.02.2025";"LP0164897c6a                        -SE MEDD.";"";"8.361,38";"749.697,33";""
"10.02.2025";"10.02.2025";"Stadeleje Roskilde";"";"-20.000,00";"729.697,33";""
"11.02.2025";"11.02.2025";"LS 38393 DANFOODS APS";"";"-581,28";"729.116,05";""
"11.02.2025";"11.02.2025";"Overførsel";"";"-31,25";"729.084,80";""
"13.02.2025";"13.02.2025";"LS 38393 DANFOODS APS";"";"-491,54";"728.593,26";""
"13.02.2025";"13.02.2025";"Depositum 1dag";"";"-6.000,00";"722.593,26";""
"13.02.2025";"13.02.2025";"MCD 00684 CIRCLE K TILST";"";"-445,88";"722.147,38";""
"13.02.2025";"13.02.2025";"MCD 00683 ASIA RESTAURANT AARHUS";"";"-534,00";"721.613,38";""
"14.02.2025";"14.02.2025";"MCD 00685 CIRCLE K TILST";"";"-351,83";"721.261,55";""
"17.02.2025";"17.02.2025";"MCD 00686 SINTRA 15,60 USD kurs: 718,846100";"";"-114,83";"721.146,72";""
"17.02.2025";"17.02.2025";"MCD 00687 A SIAM SUSHI AP";"";"-1.460,00";"719.686,72";""
"17.02.2025";"17.02.2025";"Online Banking";"";"-690,00";"718.996,72";""
"18.02.2025";"18.02.2025";"MCD 00688 Q8 Aarhus N 8015";"";"-500,00";"718.496,72";""
"20.02.2025";"20.02.2025";"MCD 00691 Q8 Aarhus N 8015";"";"-300,00";"718.196,72";""
"20.02.2025";"20.02.2025";"MCD 00692 Q8 Kolding 8191";"";"-346,95";"717.849,77";""
"20.02.2025";"20.02.2025";"Regning 13";"";"-736,00";"717.113,77";""
"20.02.2025";"20.02.2025";"Regning 14";"";"-1.389,52";"715.724,25";""
"20.02.2025";"20.02.2025";"MCD 00690 CIRCLE K TILST";"";"-388,00";"715.336,25";""
"21.02.2025";"21.02.2025";"MCD 00689 Wash World 838";"";"-119,00";"715.217,25";""
"21.02.2025";"21.02.2025";"MCD 00693 CIRCLE K TILST";"";"-236,01";"714.981,24";""
"24.02.2025";"24.02.2025";"MCD 00702 Revolut**9393*";"";"-1.300,00";"713.681,24";""
"24.02.2025";"24.02.2025";"MCD 00704 Lunar Top-up";"";"-504,00";"713.177,24";""
"24.02.2025";"24.02.2025";"MCD 00696 MCD ÅRHUS BANEGÅRD";"";"-12,00";"713.165,24";""
"24.02.2025";"24.02.2025";"MCD 00695 NYX*ArkadApS";"";"-22,00";"713.143,24";""
"24.02.2025";"24.02.2025";"MCD 00705 NETTO HELHEDEN";"";"-67,50";"713.075,74";""
"24.02.2025";"24.02.2025";"MCD 00699 BRUUNÀS GALLERI";"";"-72,00";"713.003,74";""
"24.02.2025";"24.02.2025";"MCD 00698 D'LET - DET GR@";"";"-281,33";"712.722,41";""
"24.02.2025";"24.02.2025";"MCD 00701 Schweizerbageriet";"";"-375,00";"712.347,41";""
"24.02.2025";"24.02.2025";"MCD 00703 Cafe SISI";"";"-467,50";"711.879,91";""
"24.02.2025";"24.02.2025";"MCD 00697 SALLING STORMAG";"";"-1.704,00";"710.175,91";""
"24.02.2025";"24.02.2025";"MCD 00706 FIVERR * 24,10 USD kurs: 713,983400";"";"-176,20";"709.999,71";""
"24.02.2025";"24.02.2025";"MCD 00707 APPLE.COM/BILL";"";"-59,00";"709.940,71";""
"24.02.2025";"24.02.2025";"MCD 00708 Coop365 Roende";"";"-109,95";"709.830,76";""
"24.02.2025";"24.02.2025";"MCD 00694 interflora.dk";"";"-626,00";"709.204,76";""
"24.02.2025";"24.02.2025";"LS 38393 DANFOODS APS";"";"-1.129,69";"708.075,07";""
"24.02.2025";"24.02.2025";"MCD 00710 BILKA TILST";"";"-130,38";"707.944,69";""
"24.02.2025";"24.02.2025";"MCD 00714 MCD TILST";"";"-186,00";"707.758,69";""
"24.02.2025";"24.02.2025";"MCD 00712 CIRCLE K TILST";"";"-194,28";"707.564,41";""
"24.02.2025";"24.02.2025";"MCD 00713 NETTO TILST";"";"-214,50";"707.349,91";""
"24.02.2025";"24.02.2025";"MCD 00711 CARLS JR. TILST";"";"-233,00";"707.116,91";""
"24.02.2025";"24.02.2025";"MCD 00709 BILKA TILST";"";"-414,95";"706.701,96";""
"24.02.2025";"24.02.2025";"BW STREETFOOD aps                   -SE MEDD.";"";"-10.000,00";"696.701,96";""
"24.02.2025";"24.02.2025";"John Sørensen sagsnr. I942717-0290.";"";"-1.925,55";"694.776,41";""
"25.02.2025";"25.02.2025";"LS 38393 DANFOODS APS";"";"-836,79";"693.939,62";""
"25.02.2025";"25.02.2025";"MCD 00716 B253 DK AAH Dunkin 510";"";"-307,00";"693.632,62";""
"25.02.2025";"25.02.2025";"MCD 00715 Royal Indian Sankt Knu";"";"-555,00";"693.077,62";""
"25.02.2025";"25.02.2025";"Lager";"";"-21.562,50";"671.515,12";""
"26.02.2025";"26.02.2025";"Tank to go";"";"-300,00";"671.215,12";""
"26.02.2025";"26.02.2025";"Stripe Technology Eu                -SE MEDD.";"";"10.616,50";"681.831,62";""
"26.02.2025";"26.02.2025";"MCD 00717 BILKA TILST";"";"-37,46";"681.794,16";""
"26.02.2025";"26.02.2025";"MCD 00722 REMA 1000 TILST";"";"-48,00";"681.746,16";""
"26.02.2025";"26.02.2025";"MCD 00724 CIRCLE K RONDE";"";"-118,00";"681.628,16";""
"26.02.2025";"26.02.2025";"MCD 00721 REMA 1000 TILST";"";"-162,25";"681.465,91";""
"26.02.2025";"26.02.2025";"MCD 00723 CIRCLE K RANDERSVEJ, A";"";"-300,34";"681.165,57";""
"26.02.2025";"26.02.2025";"MCD 00720 3176 Maxi Zoo Skejby";"";"-576,00";"680.589,57";""
"26.02.2025";"26.02.2025";"MCD 00719 IKEA AARHUS IF CUSTOME";"";"-80,00";"680.509,57";""
"27.02.2025";"27.02.2025";"LS 38393 DANFOODS APS";"";"-1.409,17";"679.100,40";""
"27.02.2025";"27.02.2025";"MCD 00726 CIRCLE K AARS";"";"-35,00";"679.065,40";""
"27.02.2025";"27.02.2025";"MCD 00718 BURGER KING - T";"";"-176,00";"678.889,40";""
"27.02.2025";"27.02.2025";"MCD 00725 CIRCLE K TILST";"";"-400,79";"678.488,61";""
"27.02.2025";"27.02.2025";"DFIM opkrævning Motorkøretøjsforsik";"";"-3.750,00";"674.738,61";""
"27.02.2025";"27.02.2025";"TRYG motorforsikring";"";"-2.440,37";"672.298,24";""
"28.02.2025";"28.02.2025";"Kundegebyr";"";"-200,00";"672.098,24";""
"03.03.2025";"03.03.2025";"MCD 00727 CIRCLE K TILST";"";"-450,57";"671.647,67";""
"04.03.2025";"04.03.2025";"BS TELENOR A/S";"";"-260,12";"671.387,55";""
"04.03.2025";"04.03.2025";"LS 38393 DANFOODS APS";"";"-533,58";"670.853,97";""
"04.03.2025";"04.03.2025";"BW STREET FOOD APS                  -SE MEDD.";"";"-7.500,00";"663.353,97";""
"04.03.2025";"04.03.2025";"J.S Production A/S Østergade 15";"";"-12.000,00";"651.353,97";""
"05.03.2025";"05.03.2025";"Cirkle k";"";"-567,00";"650.786,97";""
"05.03.2025";"05.03.2025";"MCD 00729 King Buffet ApS";"";"-780,00";"650.006,97";""
"05.03.2025";"05.03.2025";"Overførsel: 6695-1011704367";"";"-2.000,00";"648.006,97";""
"06.03.2025";"06.03.2025";"MCD 00732 CIRCLE K TILST";"";"-67,00";"647.939,97";""
"06.03.2025";"06.03.2025";"MCD 00730 CIRCLE K TILST";"";"-70,00";"647.869,97";""
"06.03.2025";"06.03.2025";"MCD 00731 CIRCLE K TILST";"";"-295,58";"647.574,39";""
"07.03.2025";"07.03.2025";"LS 38393 DANFOODS APS";"";"-152,98";"647.421,41";""
"07.03.2025";"07.03.2025";"MCD 00733 CIRCLE K TILST";"";"-353,55";"647.067,86";""
"10.03.2025";"10.03.2025";"MCD 00734 A LA TURCA 16,00 EUR kurs: 746,000000";"";"-120,76";"646.947,10";""
"10.03.2025";"10.03.2025";"MCD 00735 CIRCLE K TILST";"";"-300,02";"646.647,08";""
"10.03.2025";"10.03.2025";"BS AURA A/S - FIBER";"";"-299,00";"646.348,08";""
"10.03.2025";"10.03.2025";"Fakturanr 633347 jhs";"";"-268,89";"646.079,19";""
"10.03.2025";"10.03.2025";"Fakturanr 625228";"";"-754,45";"645.324,74";""
"10.03.2025";"10.03.2025";"Kontrolafgift";"";"-875,00";"644.449,74";""
"11.03.2025";"11.03.2025";"LS 38393 DANFOODS APS";"";"-322,16";"644.127,58";""
"11.03.2025";"11.03.2025";"MCD 00736 APPLE.COM/BILL";"";"-179,00";"643.948,58";""
"11.03.2025";"11.03.2025";"Overførsel";"";"-31,25";"643.917,33";""
"13.03.2025";"13.03.2025";"MCD 00737 Lunar Top-up";"";"-1.004,00";"642.913,33";""
"13.03.2025";"13.03.2025";"MCD 00738 HASLE CITY APS";"";"-156,40";"642.756,93";""
"13.03.2025";"13.03.2025";"MCD 00739 Hasle City Slagter";"";"-199,43";"642.557,50";""
"13.03.2025";"13.03.2025";"MCD 00740 1-2-3 ULFBORG";"";"-707,91";"641.849,59";""
"14.03.2025";"14.03.2025";"LS 38393 DANFOODS APS";"";"-438,83";"641.410,76";""
"14.03.2025";"14.03.2025";"MCD 00741 NETTO TILST";"";"-89,65";"641.321,11";""
"14.03.2025";"14.03.2025";"MCD 00742 JOYISTORE.COM";"";"-71,58";"641.249,53";""
"14.03.2025";"14.03.2025";"Sørby Marked - stadeplads";"";"-7.000,00";"634.249,53";""
"17.03.2025";"17.03.2025";"MCD 00745 SINTRA 15,60 USD kurs: 689,423000";"";"-110,13";"634.139,40";""
"17.03.2025";"17.03.2025";"MCD 00743 Lunar Top-up";"";"-384,00";"633.755,40";""
"17.03.2025";"17.03.2025";"MCD 00744 NETTO TILST";"";"-193,28";"633.562,12";""
"17.03.2025";"17.03.2025";"MCD 00746 YOGO BUTIKKEN";"";"-243,94";"633.318,18";""
"17.03.2025";"17.03.2025";"MCD 00751 APPLE.COM/BILL";"";"-49,00";"633.269,18";""
"17.03.2025";"17.03.2025";"MCD 00747 LIDL ÅRHUS V";"";"-146,00";"633.123,18";""
"17.03.2025";"17.03.2025";"MCD 00749 MCD TILST";"";"-152,00";"632.971,18";""
"17.03.2025";"17.03.2025";"LS 38393 DANFOODS APS";"";"-1.286,09";"631.685,09";""
"17.03.2025";"17.03.2025";"MCD 00750 Lunar Top-up";"";"-704,00";"630.981,09";""
"17.03.2025";"17.03.2025";"MCD 00748 A M Kokken ApS";"";"-140,00";"630.841,09";""
"17.03.2025";"17.03.2025";"MCD 00753 SUNSHINE SANDWI";"";"-180,00";"630.661,09";""
"17.03.2025";"17.03.2025";"MCD 00752 CIRCLE K TILST";"";"-591,90";"630.069,19";""
"17.03.2025";"17.03.2025";"PARZONE - 5054354";"";"-1.132,07";"628.937,12";""
"17.03.2025";"17.03.2025";"NRGI - 5055141";"";"-1.433,70";"627.503,42";""
"18.03.2025";"18.03.2025";"MCD 00759 MCD TILST";"";"-74,00";"627.429,42";""
"18.03.2025";"18.03.2025";"MCD 00756 NETTO S@NDERVAN";"";"-225,50";"627.203,92";""
"18.03.2025";"18.03.2025";"MCD 00754 MCD TILST";"";"-229,00";"626.974,92";""
"18.03.2025";"18.03.2025";"MCD 00755 Coop365 Kjellerup";"";"-231,95";"626.742,97";""
"18.03.2025";"18.03.2025";"MCD 00758 NETTO TILST";"";"-301,50";"626.441,47";""
"18.03.2025";"18.03.2025";"MCD 00757 KARROUM TRADING";"";"-302,90";"626.138,57";""
"19.03.2025";"19.03.2025";"BW STREET FOOD APS                  -SE MEDD.";"";"-15.000,00";"611.138,57";""
"19.03.2025";"19.03.2025";"MCD 00762 PITA HYTTEN";"";"-260,00";"610.878,57";""
"19.03.2025";"19.03.2025";"MCD 00761 Tamca ApS";"";"-805,80";"610.072,77";""
"19.03.2025";"19.03.2025";"MCD 00760 WESTERN UNION";"";"-1.276,97";"608.795,80";""
"19.03.2025";"19.03.2025";"Overførsel: 6695 1011704367";"";"-750,00";"608.045,80";""
"19.03.2025";"19.03.2025";"FÆNGSLET I HORSENS";"";"-3.625,00";"604.420,80";""
"19.03.2025";"19.03.2025";"Overførsel: 6695-1011704367";"";"-1.000,00";"603.420,80";""
"20.03.2025";"20.03.2025";"LS 38393 DANFOODS APS";"";"-935,69";"602.485,11";""
"20.03.2025";"20.03.2025";"MCD 00769 APPLE.COM/BILL";"";"-79,00";"602.406,11";""
"20.03.2025";"20.03.2025";"MCD 00767 Lunar Top-up";"";"-504,00";"601.902,11";""
"20.03.2025";"20.03.2025";"MCD 00768 Lunar Top-up";"";"-504,00";"601.398,11";""
"20.03.2025";"20.03.2025";"MCD 00764 GEJSER TILST";"";"-117,96";"601.280,15";""
"20.03.2025";"20.03.2025";"MCD 00763 CIRCLE K TILST";"";"-131,00";"601.149,15";""
"20.03.2025";"20.03.2025";"MCD 00770 CIRCLE K TILST";"";"-350,60";"600.798,55";""
"20.03.2025";"20.03.2025";"MCD 00766 REOLMARKEDET AP";"";"-51,00";"600.747,55";""
"20.03.2025";"20.03.2025";"Kontonummer: 6695 1011704367";"";"-1.000,00";"599.747,55";""
"21.03.2025";"21.03.2025";"MCD 00771 APPLE.COM/BILL";"";"-55,00";"599.692,55";""
"21.03.2025";"21.03.2025";"MCD 00765 SHELL 7-11 486";"";"-90,00";"599.602,55";""
"21.03.2025";"21.03.2025";"MCD 00773 OK VIBORG";"";"-254,80";"599.347,75";""
"21.03.2025";"21.03.2025";"MCD 00772 BAZAR ÅRHUS";"";"-315,00";"599.032,75";""
"21.03.2025";"21.03.2025";"Overførsel: 6695-1011704367";"";"-1.000,00";"598.032,75";""
"21.03.2025";"21.03.2025";"Overførsel: 6695-1011704367";"";"-1.000,00";"597.032,75";""
"24.03.2025";"24.03.2025";"Overførsel: 6695-1011704367";"";"-2.000,00";"595.032,75";""
"24.03.2025";"24.03.2025";"Overførsel: 6695-1011704367";"";"-2.500,00";"592.532,75";""
"24.03.2025";"24.03.2025";"MCD 00774 CIRCLE K TILST";"";"-350,21";"592.182,54";""
"24.03.2025";"24.03.2025";"Samsø";"";"-10.000,00";"582.182,54";""
"25.03.2025";"25.03.2025";"LS 38393 DANFOODS APS";"";"-195,05";"581.987,49";""
"25.03.2025";"25.03.2025";"Stadeplads - Horsens";"";"-6.996,44";"574.991,05";""
"25.03.2025";"25.03.2025";"MCD 00775 AL SAFADI";"";"-720,00";"574.271,05";""
"26.03.2025";"26.03.2025";"Stadeplads - Smag";"";"-2.500,00";"571.771,05";""
"27.03.2025";"27.03.2025";"LS 38393 DANFOODS APS";"";"-1.376,74";"570.394,31";""
"27.03.2025";"27.03.2025";"MCD 00776 DAGROFA S/ENGRO";"";"-610,28";"569.784,03";""
"28.03.2025";"28.03.2025";"LS 38393 DANFOODS APS";"";"-358,50";"569.425,53";""
"31.03.2025";"31.03.2025";"MCD 00777 CIRCLE K TILST";"";"-251,54";"569.173,99";""
"31.03.2025";"31.03.2025";"MCD 00778 CIRCLE K TILST";"";"-699,40";"568.474,59";""
"31.03.2025";"31.03.2025";"Klostermærken 2. Biler";"";"-10.000,00";"558.474,59";""
"31.03.2025";"31.03.2025";"Online Banking gebyrer";"";"-925,70";"557.548,89";""
"31.03.2025";"31.03.2025";"Kundegebyr";"";"-200,00";"557.348,89";""
"31.03.2025";"31.03.2025";"OS Lønovf. - bogf. hos modtager 3";"";"-1,50";"557.347,39";""
"31.03.2025";"31.03.2025";"OS Lønovf. - træk på jeres konto 3";"";"-1,50";"557.345,89";""
"01.04.2025";"01.04.2025";"BS TELENOR A/S";"";"-254,38";"557.091,51";""
"01.04.2025";"01.04.2025";"LS 38393 DANFOODS APS";"";"-221,44";"556.870,07";""
"01.04.2025";"01.04.2025";"MCD 00779 CIRCLE K SKANDERBORGVE";"";"-201,88";"556.668,19";""
"02.04.2025";"02.04.2025";"MCD 00780 CIRCLE K ARHUS V";"";"-546,59";"556.121,60";""
"02.04.2025";"02.04.2025";"Tilbagebetaling lån af bil";"";"-35.000,00";"521.121,60";""
"02.04.2025";"02.04.2025";"Bilkøb";"";"-30.000,00";"491.121,60";""
"04.04.2025";"04.04.2025";"BW STREET FOOD APS                  -SE MEDD.";"";"-25.000,00";"466.121,60";""
"04.04.2025";"04.04.2025";"MCD 00782 Lunar Top-up";"";"-1.004,00";"465.117,60";""
"04.04.2025";"04.04.2025";"MCD 00781 CIRCLE K TILST";"";"-727,41";"464.390,19";""
"04.04.2025";"04.04.2025";"Haderslev stadeplads";"";"-5.000,00";"459.390,19";""
"07.04.2025";"07.04.2025";"MCD 00788 Lunar Top-up";"";"-4.004,00";"455.386,19";""
"07.04.2025";"07.04.2025";"MCD 00787 KEBAP HEROES GMBH 6,00 EUR kurs: 746,333300";"";"-45,30";"455.340,89";""
"07.04.2025";"07.04.2025";"MCD 00786 KEBAP HEROES GMBH 25,50 EUR kurs: 746,313700";"";"-192,54";"455.148,35";""
"07.04.2025";"07.04.2025";"MCD 00789 Parfuemerie Douglas 27,99 EUR kurs: 746,302200";"";"-211,33";"454.937,02";""
"07.04.2025";"07.04.2025";"MCD 00785 CIRCLE K HORSENSVEJ, V";"";"-250,74";"454.686,28";""
"07.04.2025";"07.04.2025";"MCD 00784 CIRCLE K TILST";"";"-619,90";"454.066,38";""
"07.04.2025";"07.04.2025";"MCD 00783 Elgiganten.dk";"";"-2.297,00";"451.769,38";""
"07.04.2025";"07.04.2025";"MCD 00791 BAUHAUS";"";"-116,01";"451.653,37";""
"07.04.2025";"07.04.2025";"MCD 00790 BAUHAUS";"";"-189,37";"451.464,00";""
"07.04.2025";"07.04.2025";"MCD 00794 TV2 DK* ID 199346921";"";"-179,00";"451.285,00";""
"07.04.2025";"07.04.2025";"MCD 00792 CIRCLE K HORSENSVEJ, V";"";"-300,33";"450.984,67";""
"07.04.2025";"07.04.2025";"MCD 00795 The Pita House Randers";"";"-366,95";"450.617,72";""
"08.04.2025";"08.04.2025";"MCD 00799 Elgiganten Viby";"";"-1.367,00";"449.250,72";""
"08.04.2025";"08.04.2025";"MCD 00797 Revolut**3930*";"";"-5.000,00";"444.250,72";""
"08.04.2025";"08.04.2025";"MCD 00796 CIRCLE K TILST";"";"-300,98";"443.949,74";""
"08.04.2025";"08.04.2025";"MCD 00798 DANFOODS APS";"";"-721,49";"443.228,25";""
"09.04.2025";"09.04.2025";"LS 38393 DANFOODS APS";"";"-559,06";"442.669,19";""
"09.04.2025";"09.04.2025";"MCD 00803 Simply.com";"";"-59,70";"442.609,49";""
"09.04.2025";"09.04.2025";"MCD 00800 CIRCLE K TILST";"";"-68,00";"442.541,49";""
"09.04.2025";"09.04.2025";"MCD 00801 BURGER BOOM TR@";"";"-233,00";"442.308,49";""
"09.04.2025";"09.04.2025";"MCD 00804 FIVERR * 358,70 USD kurs: 685,709500";"";"-2.518,67";"439.789,82";""
"09.04.2025";"09.04.2025";"MCD 00802 BR BRUUNS GALLE";"";"-668,00";"439.121,82";""
"09.04.2025";"09.04.2025";"MCD 00805 FIVERR * 83,18 USD kurs: 685,705600";"";"-584,06";"438.537,76";""
"10.04.2025";"10.04.2025";"BS AURA A/S - FIBER";"";"-299,00";"438.238,76";""
"10.04.2025";"10.04.2025";"LS 38393 DANFOODS APS";"";"-379,57";"437.859,19";""
"10.04.2025";"10.04.2025";"MCD 00806 FIVERR * 168,80 USD kurs: 685,710900";"";"-1.185,26";"436.673,93";""
"10.04.2025";"10.04.2025";"MCD 00808 FIVERR * 907,30 USD kurs: 685,710300";"";"-6.370,76";"430.303,17";""
"10.04.2025";"10.04.2025";"MCD 00813 Simply.com";"";"-60,56";"430.242,61";""
"10.04.2025";"10.04.2025";"MCD 00812 FIVERR * 66,30 USD kurs: 685,128200";"";"-465,14";"429.777,47";""
"10.04.2025";"10.04.2025";"MCD 00811 CIRCLE K TILST";"";"-150,04";"429.627,43";""
"10.04.2025";"10.04.2025";"MCD 00807 Inco CC Aarhus AS";"";"-222,37";"429.405,06";""
"10.04.2025";"10.04.2025";"MCD 00809 BAUHAUS";"";"-777,51";"428.627,55";""
"10.04.2025";"10.04.2025";"MCD 00810 NEMPHONE APS";"";"-1.095,00";"427.532,55";""
"11.04.2025";"11.04.2025";"LS 28924 VISMA E-CONOMIC A/S";"";"-1.308,75";"426.223,80";""
"11.04.2025";"11.04.2025";"MCD 00814 APPLE.COM/BILL";"";"-179,00";"426.044,80";""
"11.04.2025";"11.04.2025";"MCD 00816 HASLE CITY APS";"";"-70,00";"425.974,80";""
"11.04.2025";"11.04.2025";"MCD 00815 SUNSHINE SANDWI";"";"-210,00";"425.764,80";""
"14.04.2025";"14.04.2025";"MCD 00817 AIRBNB * HM2MH4JKYA";"";"-1.647,06";"424.117,74";""
"14.04.2025";"14.04.2025";"MCD 00818 CIRCLE K TILST";"";"-791,31";"423.326,43";""
"14.04.2025";"14.04.2025";"MCD 00820 CIRCLE K MOTORVEJSCENT";"";"-350,19";"422.976,24";""
"14.04.2025";"14.04.2025";"MCD 00819 590 STARK GLOSTRUP";"";"-500,00";"422.476,24";""
"14.04.2025";"14.04.2025";"Jura";"";"-5.100,00";"417.376,24";""
"14.04.2025";"14.04.2025";"BW STREET FOOD APS                  -SE MEDD.";"";"-13.125,00";"404.251,24";""
"14.04.2025";"14.04.2025";"MCD 00821 F@TEX @STERBRO";"";"-115,00";"404.136,24";""
"14.04.2025";"14.04.2025";"MCD 00823 MOLSLINJEN A/S";"";"-150,00";"403.986,24";""
"14.04.2025";"14.04.2025";"MCD 00826 NETTO S@NDERVAN";"";"-282,80";"403.703,44";""
"14.04.2025";"14.04.2025";"MCD 00825 Express 4";"";"-312,00";"403.391,44";""
"14.04.2025";"14.04.2025";"MCD 00822 DAGROFA S/ENGRO";"";"-764,12";"402.627,32";""
"14.04.2025";"14.04.2025";"LP1fa6142f08                        -SE MEDD.";"";"32.610,99";"435.238,31";""
"14.04.2025";"14.04.2025";"Reklame instagram";"";"-900,00";"434.338,31";""
"15.04.2025";"15.04.2025";"LS 38393 DANFOODS APS";"";"-3.141,64";"431.196,67";""
"15.04.2025";"15.04.2025";"MCD 00834 SINTRA 15,60 USD kurs: 667,435800";"";"-106,62";"431.090,05";""
"15.04.2025";"15.04.2025";"MCD 00828 FIVERR * 55,75 USD kurs: 667,443900";"";"-381,03";"430.709,02";""
"15.04.2025";"15.04.2025";"MCD 00832 Q-PARK MAGASIN";"";"-27,00";"430.682,02";""
"15.04.2025";"15.04.2025";"MCD 00833 Q-PARK MAGASIN";"";"-27,00";"430.655,02";""
"15.04.2025";"15.04.2025";"MCD 00824 SHELL 7-11 486";"";"-118,00";"430.537,02";""
"15.04.2025";"15.04.2025";"MCD 00831 SHAWARMA KING A";"";"-192,00";"430.345,02";""
"15.04.2025";"15.04.2025";"MCD 00827 CIRCLE K TILST";"";"-250,04";"430.094,98";""
"15.04.2025";"15.04.2025";"MCD 00835 Uno-X 2486 Tilst";"";"-300,75";"429.794,23";""
"15.04.2025";"15.04.2025";"MCD 00829 Simply.com";"";"-428,00";"429.366,23";""
"15.04.2025";"15.04.2025";"MCD 00830 Magasin  AArhus";"";"-950,00";"428.416,23";""
"15.04.2025";"15.04.2025";"Overførsel";"";"-31,25";"428.384,98";""
"16.04.2025";"16.04.2025";"LS 38393 DANFOODS APS";"";"-2.560,69";"425.824,29";""
"16.04.2025";"16.04.2025";"MCD 00838 HARALD NYBORG -";"";"-90,50";"425.733,79";""
"16.04.2025";"16.04.2025";"MCD 00837 THANSEN GRUPPEN";"";"-99,90";"425.633,89";""
"16.04.2025";"16.04.2025";"MCD 00836 CIRCLE K TILST";"";"-149,00";"425.484,89";""
"16.04.2025";"16.04.2025";"MCD 00839 FIVERR * 87,40 USD kurs: 661,681900";"";"-592,19";"424.892,70";""
"16.04.2025";"16.04.2025";"Molslinjen";"";"-1.400,00";"423.492,70";""
"22.04.2025";"22.04.2025";"MCD 00842 AIRBNB * HMSJPZ82MJ";"";"-2.294,12";"421.198,58";""
"22.04.2025";"22.04.2025";"MCD 00840 THANSEN GRUPPEN";"";"-262,25";"420.936,33";""
"22.04.2025";"22.04.2025";"MCD 00841 CIRCLE K RONDE";"";"-354,24";"420.582,09";""
"22.04.2025";"22.04.2025";"MCD 00846 CinemaxX Odense";"";"-220,00";"420.362,09";""
"22.04.2025";"22.04.2025";"MCD 00847 CinemaxX Odense";"";"-327,84";"420.034,25";""
"22.04.2025";"22.04.2025";"MCD 00843 REMA 1000 BR@NS";"";"-77,00";"419.957,25";""
"22.04.2025";"22.04.2025";"MCD 00844 435 NETTO FREDE";"";"-1.126,80";"418.830,45";""
"22.04.2025";"22.04.2025";"MCD 00845 Kod Aarhus ApS";"";"-1.845,00";"416.985,45";""
"22.04.2025";"22.04.2025";"MCD 00853 NVIDIA CORPORATION";"";"-179,00";"416.806,45";""
"22.04.2025";"22.04.2025";"MCD 00849 Q8 Aarhus N 8015";"";"-616,00";"416.190,45";""
"22.04.2025";"22.04.2025";"MCD 00851 GIMA CATERING AS";"";"-1.217,81";"414.972,64";""
"22.04.2025";"22.04.2025";"MCD 00850 DAGROFA S/ENGRO";"";"-4.315,99";"410.656,65";""
"22.04.2025";"22.04.2025";"MCD 00854 APPLE.COM/BILL";"";"-69,00";"410.587,65";""
"22.04.2025";"22.04.2025";"MCD 00848 CIRCLE K TILST";"";"-350,33";"410.237,32";""
"22.04.2025";"22.04.2025";"MCD 00855 ALI BAGERI";"";"-150,00";"410.087,32";""
"22.04.2025";"22.04.2025";"MCD 00856 OIL tank go Tilst v/AA";"";"-200,06";"409.887,26";""
"22.04.2025";"22.04.2025";"MCD 00858 NETTO S@NDERVAN";"";"-350,90";"409.536,36";""
"22.04.2025";"22.04.2025";"MCD 00857 Wolt";"";"-575,00";"408.961,36";""
"22.04.2025";"22.04.2025";"MCD 00859 APPLE.COM/BILL";"";"-55,00";"408.906,36";""
"22.04.2025";"22.04.2025";"MCD 00861 FIVERR * 76,85 USD kurs: 658,503500";"";"-518,21";"408.388,15";""
"22.04.2025";"22.04.2025";"MCD 00860 FIVERR * 189,90 USD kurs: 658,509700";"";"-1.280,52";"407.107,63";""
"22.04.2025";"22.04.2025";"MCD 00869 NETTO S@NDERVAN";"";"-15,00";"407.092,63";""
"22.04.2025";"22.04.2025";"MCD 00864 CIRCLE K RONDE";"";"-70,00";"407.022,63";""
"22.04.2025";"22.04.2025";"MCD 00862 MCD VIBY 2";"";"-150,00";"406.872,63";""
"22.04.2025";"22.04.2025";"MCD 00865 Yones food";"";"-245,00";"406.627,63";""
"22.04.2025";"22.04.2025";"MCD 00867 OK Bellahoej";"";"-298,13";"406.329,50";""
"22.04.2025";"22.04.2025";"MCD 00868 NETTO S@NDERVAN";"";"-314,60";"406.014,90";""
"22.04.2025";"22.04.2025";"MCD 00863 CIRCLE K RONDE";"";"-480,90";"405.534,00";""
"22.04.2025";"22.04.2025";"MCD 00871 CIRCLE K TILST";"";"-200,77";"405.333,23";""
"22.04.2025";"22.04.2025";"MCD 00870 NETTO S@NDERVAN";"";"-314,65";"405.018,58";""
"22.04.2025";"22.04.2025";"LP19ebb95512                        -SE MEDD.";"";"22.993,69";"428.012,27";""
"23.04.2025";"23.04.2025";"LS 38393 DANFOODS APS";"";"-8.148,38";"419.863,89";""
"23.04.2025";"23.04.2025";"MCD 00872 PITA HYTTEN";"";"-125,00";"419.738,89";""
"23.04.2025";"23.04.2025";"MCD 00875 JOE  THE JUICE A/S";"";"-276,00";"419.462,89";""
"23.04.2025";"23.04.2025";"MCD 00876 Instant Gaming";"";"-380,70";"419.082,19";""
"23.04.2025";"23.04.2025";"Google ADS";"";"-2.000,00";"417.082,19";""
"23.04.2025";"23.04.2025";"MCD 00874 Sunset-Boulevard RDB";"";"-138,00";"416.944,19";""
"23.04.2025";"23.04.2025";"MCD 00873 CIRCLE K ARHUS V";"";"-141,80";"416.802,39";""
"24.04.2025";"24.04.2025";"MCD 00877 Lunar Top-up";"";"-1.370,00";"415.432,39";""
"24.04.2025";"24.04.2025";"MCD 00879 Wolt";"";"-154,76";"415.277,63";""
"24.04.2025";"24.04.2025";"MCD 00878 CIRCLE K RANDERSVEJ, A";"";"-170,00";"415.107,63";""
"24.04.2025";"24.04.2025";"MCD 00883 WINDSURF 18,75 USD kurs: 660,373300";"";"-126,79";"414.980,84";""
"25.04.2025";"25.04.2025";"LS 38393 DANFOODS APS";"";"-3.293,41";"411.687,43";""
"25.04.2025";"25.04.2025";"Marselisborg Streetfoodiss";"";"-3.250,00";"408.437,43";""
"25.04.2025";"25.04.2025";"MCD 00881 AARHUS BUSINESS";"";"-37,00";"408.400,43";""
"25.04.2025";"25.04.2025";"MCD 00880 CIRCLE K TILST";"";"-386,06";"408.014,37";""
"25.04.2025";"25.04.2025";"MCD 00882 DAGROFA S/ENGRO";"";"-2.284,06";"405.730,31";""
"25.04.2025";"25.04.2025";"MCD 00885 Revolut**3930*";"";"-2.500,00";"403.230,31";""
"28.04.2025";"28.04.2025";"MCD 00884 OK Hasle";"";"-350,00";"402.880,31";""
"28.04.2025";"28.04.2025";"LS 38393 DANFOODS APS";"";"-469,38";"402.410,93";""
"28.04.2025";"28.04.2025";"MCD 00889 APPLE.COM/BILL";"";"-49,00";"402.361,93";""
"28.04.2025";"28.04.2025";"MCD 00890 OK Tilst";"";"-600,36";"401.761,57";""
"28.04.2025";"28.04.2025";"MCD 00891 Lunar Top-up";"";"-2.004,00";"399.757,57";""
"28.04.2025";"28.04.2025";"MCD 00888 LOOMIS*Cafe Skytten A";"";"-30,00";"399.727,57";""
"28.04.2025";"28.04.2025";"MCD 00886 CIRCLE K TILST";"";"-169,00";"399.558,57";""
"28.04.2025";"28.04.2025";"MCD 00887 Al meza";"";"-507,00";"399.051,57";""
"28.04.2025";"28.04.2025";"LP50a17a3ba6                        -SE MEDD.";"";"84.423,42";"483.474,99";""
"28.04.2025";"28.04.2025";"Køb af fryser";"";"-5.000,00";"478.474,99";""
"29.04.2025";"29.04.2025";"LS 38393 DANFOODS APS";"";"-3.768,04";"474.706,95";""
"29.04.2025";"29.04.2025";"MCD 00892 Revolut**3930*";"";"-600,00";"474.106,95";""
"29.04.2025";"29.04.2025";"MCD 00896 Lunar Top-up";"";"-1.104,00";"473.002,95";""
"29.04.2025";"29.04.2025";"MCD 00893 Kft Jylland ApS";"";"-7,95";"472.995,00";""
"29.04.2025";"29.04.2025";"MCD 00894 Fakta 96";"";"-70,00";"472.925,00";""
"29.04.2025";"29.04.2025";"MCD 00895 IMO Tilst";"";"-199,00";"472.726,00";""
"30.04.2025";"30.04.2025";"Kundegebyr";"";"-200,00";"472.526,00";""
"30.04.2025";"30.04.2025";"LS 38393 DANFOODS APS";"";"-3.525,69";"469.000,31";""
"30.04.2025";"30.04.2025";"Roskilde Musik & Kræmmemarked 17904";"";"-11.875,00";"457.125,31";""
"30.04.2025";"30.04.2025";"MCD 00898 SOMMERKIOSK AKR";"";"-108,00";"457.017,31";""
"30.04.2025";"30.04.2025";"MCD 00900 STORCENTER NORD";"";"-159,95";"456.857,36";""
"30.04.2025";"30.04.2025";"MCD 00901 MCD TILST";"";"-163,00";"456.694,36";""
"30.04.2025";"30.04.2025";"MCD 00899 Q8 Holstebro 8104";"";"-300,00";"456.394,36";""
"30.04.2025";"30.04.2025";"MCD 00897 REMA 1000 EGÅ";"";"-334,25";"456.060,11";""
"01.05.2025";"01.05.2025";"LS 38393 DANFOODS APS";"";"-3.117,55";"452.942,56";""
"01.05.2025";"01.05.2025";"MCD 00904 AIRBNB * HMT2N4EPT5";"";"-3.082,35";"449.860,21";""
"01.05.2025";"01.05.2025";"MCD 00906 Storebaeltsforbindelse";"";"-350,00";"449.510,21";""
"01.05.2025";"01.05.2025";"MCD 00905 CIRCLE K TILST";"";"-803,23";"448.706,98";""
"01.05.2025";"01.05.2025";"MCD 00902 DEKRA Bilsyn - Tilst";"";"-1.495,00";"447.211,98";""
"01.05.2025";"01.05.2025";"MCD 00903 DAGROFA S/ENGRO";"";"-2.190,79";"445.021,19";""
"02.05.2025";"02.05.2025";"02000118060010105252                -SE MEDD.";"";"16.291,14";"461.312,33";""
"02.05.2025";"02.05.2025";"BS TELENOR A/S";"";"-254,38";"461.057,95";""
"02.05.2025";"02.05.2025";"LS 38393 DANFOODS APS";"";"-1.845,31";"459.212,64";""
"02.05.2025";"02.05.2025";"MCD 00909 Lunar Top-up";"";"-904,00";"458.308,64";""
"02.05.2025";"02.05.2025";"MCD 00910 AIRBNB * HMP995C8Y3";"";"-1.941,17";"456.367,47";""
"02.05.2025";"02.05.2025";"MCD 00908 Lunar Top-up";"";"-2.904,00";"453.463,47";""
"02.05.2025";"02.05.2025";"MCD 00907 DANTAXI";"";"-221,52";"453.241,95";""
"05.05.2025";"05.05.2025";"02000118060010205259                -SE MEDD.";"";"13.405,95";"466.647,90";""
"05.05.2025";"05.05.2025";"MCD 00911 Lunar Top-up";"";"-654,00";"465.993,90";""
"05.05.2025";"05.05.2025";"MCD 00915 REMA 1000 ROSKI";"";"-80,60";"465.913,30";""
"05.05.2025";"05.05.2025";"MCD 00912 NETTO SAKSK@BIN";"";"-92,80";"465.820,50";""
"05.05.2025";"05.05.2025";"MCD 00914 DAGROFA S/ENGRO";"";"-385,69";"465.434,81";""
"05.05.2025";"05.05.2025";"MCD 00916 Q8 Roskilde 8155";"";"-442,00";"464.992,81";""
"05.05.2025";"05.05.2025";"MCD 00913 DAGROFA S/ENGRO";"";"-3.055,56";"461.937,25";""
"05.05.2025";"05.05.2025";"02000118060010305256                -SE MEDD.";"";"3.410,90";"465.348,15";""
"05.05.2025";"05.05.2025";"MCD 00918 CIRCLE K SONDRE RINGVE";"";"-332,50";"465.015,65";""
"05.05.2025";"05.05.2025";"MCD 00917 DAGROFA S/ENGRO";"";"-2.191,42";"462.824,23";""
"05.05.2025";"05.05.2025";"02000118060010405253                -SE MEDD.";"";"292,08";"463.116,31";""
"05.05.2025";"05.05.2025";"MCD 00920 REMA 1000 SAKSK";"";"-337,80";"462.778,51";""
"05.05.2025";"05.05.2025";"MCD 00919 DAGROFA S/ENGRO";"";"-1.276,57";"461.501,94";""
"05.05.2025";"05.05.2025";"MCD 00921 Lunar Top-up";"";"-1.504,00";"459.997,94";""
"05.05.2025";"05.05.2025";"LP097201e561                        -SE MEDD.";"";"81.056,31";"541.054,25";""
"07.05.2025";"07.05.2025";"LS 38393 DANFOODS APS";"";"-842,89";"540.211,36";""
"07.05.2025";"07.05.2025";"MCD 00925 TV2 DK* ID 200946914";"";"-179,00";"540.032,36";""
"07.05.2025";"07.05.2025";"MCD 00923 GENBRUGSLAND";"";"-22,50";"540.009,86";""
"07.05.2025";"07.05.2025";"MCD 00924 THANSEN GRUPPEN";"";"-89,25";"539.920,61";""
"07.05.2025";"07.05.2025";"MCD 00922 Struer Havn Havnekonto";"";"-200,00";"539.720,61";""
"07.05.2025";"07.05.2025";"MCD 00926 SIKKER BILSYN A";"";"-275,00";"539.445,61";""
"07.05.2025";"07.05.2025";"MCD 00927 DEKRA Bilsyn Ap";"";"-290,00";"539.155,61";""
"07.05.2025";"07.05.2025";"MCD 00928 Q8 Holstebro 8250";"";"-542,00";"538.613,61";""
"08.05.2025";"08.05.2025";"LS 38393 DANFOODS APS";"";"-5.755,78";"532.857,83";""
"08.05.2025";"08.05.2025";"MCD 00929 BAUHAUS";"";"-31,80";"532.826,03";""
"09.05.2025";"09.05.2025";"LS 38393 DANFOODS APS";"";"-192,95";"532.633,08";""
"09.05.2025";"09.05.2025";"Johs.Sørensen & Sø";"";"-959,66";"531.673,42";""
"09.05.2025";"09.05.2025";"GRUNDEJERFORENING";"";"-6.250,00";"525.423,42";""
"09.05.2025";"09.05.2025";"GRUNDEJERFORENING";"";"-6.250,00";"519.173,42";""
"09.05.2025";"09.05.2025";"NusNus ApS";"";"-12.500,00";"506.673,42";""
"09.05.2025";"09.05.2025";"Posteringsovers. efter søgning";"";"-50,00";"506.623,42";""
"09.05.2025";"09.05.2025";"MCD 00930 CIRCLE K TILST";"";"-251,95";"506.371,47";""
"12.05.2025";"12.05.2025";"02000118060010905258                -SE MEDD.";"";"450,50";"506.821,97";""
"12.05.2025";"12.05.2025";"MCD 00936 L@VBJERG SUPERM";"";"-52,46";"506.769,51";""
"12.05.2025";"12.05.2025";"MCD 00932 ELIN FOOD";"";"-130,00";"506.639,51";""
"12.05.2025";"12.05.2025";"MCD 00935 F@TEX ÅBENRÅ";"";"-144,00";"506.495,51";""
"12.05.2025";"12.05.2025";"MCD 00933 CIRCLE K TILST";"";"-500,77";"505.994,74";""
"12.05.2025";"12.05.2025";"MCD 00934 Uno-X 1433 Brab Silkeb";"";"-798,73";"505.196,01";""
"12.05.2025";"12.05.2025";"MCD 00931 DAGROFA S/ENGRO";"";"-1.403,51";"503.792,50";""
"12.05.2025";"12.05.2025";"MCD 00938 APPLE.COM/BILL";"";"-179,00";"503.613,50";""
"12.05.2025";"12.05.2025";"MCD 00940 Inco CC Aarhus AS";"";"-224,82";"503.388,68";""
"12.05.2025";"12.05.2025";"MCD 00937 CIRCLE K MOTORVEJSCENT";"";"-250,02";"503.138,66";""
"12.05.2025";"12.05.2025";"MCD 00939 Inco CC Aarhus AS";"";"-657,82";"502.480,84";""
"12.05.2025";"12.05.2025";"Betalinger, 3 stk.";"";"-180,00";"502.300,84";""
"12.05.2025";"12.05.2025";"BS AURA A/S - FIBER";"";"-299,00";"502.001,84";""
"12.05.2025";"12.05.2025";"LS 38393 DANFOODS APS";"";"-2.226,19";"499.775,65";""
"12.05.2025";"12.05.2025";"Stripe Technology Eu                -SE MEDD.";"";"10.863,00";"510.638,65";""
"13.05.2025";"13.05.2025";"DK-LS-10015889 LoomisPAY";"";"-4.261,17";"506.377,48";""
"13.05.2025";"13.05.2025";"Tilbageførsel";"";"4.261,17";"510.638,65";""
"13.05.2025";"13.05.2025";"Loomis";"";"-4.261,17";"506.377,48";""
"13.05.2025";"13.05.2025";"Overførsel";"";"-31,25";"506.346,23";""
"14.05.2025";"14.05.2025";"Betalinger, 1 stk.";"";"-60,00";"506.286,23";""
"14.05.2025";"14.05.2025";"LS 38393 DANFOODS APS";"";"-4.834,69";"501.451,54";""
"15.05.2025";"15.05.2025";"MCD 00941 SINTRA 15,60 USD kurs: 674,230700";"";"-107,70";"501.343,84";""
"16.05.2025";"16.05.2025";"LS 38393 DANFOODS APS";"";"-381,24";"500.962,60";""
"16.05.2025";"16.05.2025";"Gebyr - Standard overførsel";"";"-300,00";"500.662,60";""
"16.05.2025";"16.05.2025";"BW Streetfood ApS                   -SE MEDD.";"";"-25.000,00";"475.662,60";""
"16.05.2025";"16.05.2025";"MCD 00943 CIRCLE K TILST";"";"-64,95";"475.597,65";""
"16.05.2025";"16.05.2025";"MCD 00942 CIRCLE K TILST";"";"-99,90";"475.497,75";""
"16.05.2025";"16.05.2025";"MCD 00945 Elgiganten Tilst";"";"-369,00";"475.128,75";""
"19.05.2025";"19.05.2025";"02000118060011605256                -SE MEDD.";"";"69,31";"475.198,06";""
"19.05.2025";"19.05.2025";"MCD 00947 CIRCLE K TILST";"";"-746,28";"474.451,78";""
"19.05.2025";"19.05.2025";"MCD 00946 DAGROFA S/ENGRO";"";"-1.570,89";"472.880,89";""
"19.05.2025";"19.05.2025";"MCD 00944 Mardin Food ApS";"";"-2.100,06";"470.780,83";""
"19.05.2025";"19.05.2025";"02000118060011705253                -SE MEDD.";"";"618,81";"471.399,64";""
"19.05.2025";"19.05.2025";"MCD 00949 Coop365 Randersv.";"";"-33,90";"471.365,74";""
"19.05.2025";"19.05.2025";"MCD 00948 CIRCLE K NORREBROG.,HO";"";"-1.000,00";"470.365,74";""
"19.05.2025";"19.05.2025";"02000118060011805250                -SE MEDD.";"";"341,59";"470.707,33";""
"19.05.2025";"19.05.2025";"LS 38393 DANFOODS APS";"";"-3.621,19";"467.086,14";""
"19.05.2025";"19.05.2025";"MCD 00952 SumUp  *Foodtruck Fies";"";"-130,00";"466.956,14";""
"19.05.2025";"19.05.2025";"MCD 00951 NVIDIA CORPORATION";"";"-179,00";"466.777,14";""
"19.05.2025";"19.05.2025";"MCD 00950 CIRCLE K BREGNEVEJ, SI";"";"-319,00";"466.458,14";""
"19.05.2025";"19.05.2025";"LP10ba0e03db                        -SE MEDD.";"";"16.597,09";"483.055,23";""
"20.05.2025";"20.05.2025";"LS 38393 DANFOODS APS";"";"-3.779,24";"479.275,99";""
"20.05.2025";"20.05.2025";"Vildbjerg Handelsforening";"";"-3.750,00";"475.525,99";""
"20.05.2025";"20.05.2025";"Århus Catering";"";"-3.776,25";"471.749,74";""
"20.05.2025";"20.05.2025";"MCD 00954 APPLE.COM/BILL";"";"-55,00";"471.694,74";""
"20.05.2025";"20.05.2025";"MCD 00953 DEKRA BILSYN TI";"";"-1.495,00";"470.199,74";""
"21.05.2025";"21.05.2025";"Betalinger, 2 stk.";"";"-120,00";"470.079,74";""
"21.05.2025";"21.05.2025";"LS 38393 DANFOODS APS";"";"-212,71";"469.867,03";""
"21.05.2025";"21.05.2025";"REphone";"";"-2.100,00";"467.767,03";""
"21.05.2025";"21.05.2025";"MCD 00955 Elgiganten Viby";"";"-758,00";"467.009,03";""
"22.05.2025";"22.05.2025";"Betalinger, 1 stk.";"";"-60,00";"466.949,03";""
"22.05.2025";"22.05.2025";"LS 38393 DANFOODS APS";"";"-6.047,50";"460.901,53";""
"22.05.2025";"22.05.2025";"CHPevent";"";"-6.250,00";"454.651,53";""
"22.05.2025";"22.05.2025";"Århus Catering";"";"-3.401,25";"451.250,28";""
"23.05.2025";"23.05.2025";"Betalinger, 2 stk.";"";"-120,00";"451.130,28";""
"23.05.2025";"23.05.2025";"LS 38393 DANFOODS APS";"";"-2.257,89";"448.872,39";""
"23.05.2025";"23.05.2025";"GOOGLE ADS";"";"-2.000,00";"446.872,39";""
"23.05.2025";"23.05.2025";"MCD 00958 THANSEN GRUPPEN";"";"-270,40";"446.601,99";""
"23.05.2025";"23.05.2025";"MCD 00956 THANSEN GRUPPEN";"";"-749,00";"445.852,99";""
"23.05.2025";"23.05.2025";"MCD 00959 HARALD NYBORG -";"";"-908,00";"444.944,99";""
"23.05.2025";"23.05.2025";"MCD 00957 DAGROFA S/ENGRO";"";"-4.693,11";"440.251,88";""
"26.05.2025";"26.05.2025";"02000118060012305254                -SE MEDD.";"";"168,32";"440.420,20";""
"26.05.2025";"26.05.2025";"MCD 00965 AIRBNB * HM8PSDN95X";"";"-1.284,71";"439.135,49";""
"26.05.2025";"26.05.2025";"MCD 00963 CIRCLE K TILST";"";"-450,67";"438.684,82";""
"26.05.2025";"26.05.2025";"MCD 00964 CIRCLE K TILST";"";"-454,98";"438.229,84";""
"26.05.2025";"26.05.2025";"MCD 00962 OIL tank go Greve";"";"-492,09";"437.737,75";""
"26.05.2025";"26.05.2025";"MCD 00960 Storebaeltsforbindelse";"";"-635,00";"437.102,75";""
"26.05.2025";"26.05.2025";"MCD 00961 MINA ISTANBUL KEBAB PR";"";"-14.331,00";"422.771,75";""
"26.05.2025";"26.05.2025";"02000118060012405251                -SE MEDD.";"";"2.188,13";"424.959,88";""
"26.05.2025";"26.05.2025";"MCD 00968 WINDSURF 18,75 USD kurs: 662,773300";"";"-127,25";"424.832,63";""
"26.05.2025";"26.05.2025";"MCD 00967 Inco CC Aarhus AS";"";"-131,22";"424.701,41";""
"26.05.2025";"26.05.2025";"MCD 00966 CIRCLE K TILST";"";"-351,00";"424.350,41";""
"26.05.2025";"26.05.2025";"LS 38393 DANFOODS APS";"";"-2.639,75";"421.710,66";""
"26.05.2025";"26.05.2025";"02000118060012505258                -SE MEDD.";"";"99,00";"421.809,66";""
"26.05.2025";"26.05.2025";"Stripe Technology Eu                -SE MEDD.";"";"13.003,30";"434.812,96";""
"26.05.2025";"26.05.2025";"MCD 00969 Q8 Låsby 8206";"";"-200,00";"434.612,96";""
"26.05.2025";"26.05.2025";"MCD 00970 Storebaeltsforbindelse";"";"-230,00";"434.382,96";""
"26.05.2025";"26.05.2025";"MCD 00971 Storebaeltsforbindelse";"";"-230,00";"434.152,96";""
"26.05.2025";"26.05.2025";"META FACEBOOK ADS";"";"-1.380,51";"432.772,45";""
"27.05.2025";"27.05.2025";"Betalinger, 1 stk.";"";"-60,00";"432.712,45";""
"27.05.2025";"27.05.2025";"LS 38393 DANFOODS APS";"";"-2.588,65";"430.123,80";""
"28.05.2025";"28.05.2025";"Kundegebyr";"";"-200,00";"429.923,80";""
"28.05.2025";"28.05.2025";"MCD 00972 Simply.com";"";"-68,59";"429.855,21";""
"02.06.2025";"02.06.2025";"MCD 00974 CIRCLE K ARHUS V";"";"-400,08";"429.455,13";""
"02.06.2025";"02.06.2025";"MCD 00973 DAGROFA S/ENGRO";"";"-2.574,86";"426.880,27";""
"02.06.2025";"02.06.2025";"MCD 00980 AIRBNB * HMHFMWNEQN";"";"-2.643,52";"424.236,75";""
"02.06.2025";"02.06.2025";"02000118060012905256                -SE MEDD.";"";"8.405,96";"432.642,71";""
"02.06.2025";"02.06.2025";"MCD 00982 Storebaeltsforbindelse";"";"-230,00";"432.412,71";""
"02.06.2025";"02.06.2025";"MCD 00983 Storebaeltsforbindelse";"";"-230,00";"432.182,71";""
"02.06.2025";"02.06.2025";"MCD 00981 Storebaeltsforbindelse";"";"-350,00";"431.832,71";""
"02.06.2025";"02.06.2025";"MCD 00985 AIRBNB * HMTZHNDAZ3";"";"-729,41";"431.103,30";""
"02.06.2025";"02.06.2025";"MCD 00984 DAGROFA S/ENGRO";"";"-1.954,56";"429.148,74";""
"02.06.2025";"02.06.2025";"MCD 00979 CIRCLE K MOTORVEJSCENT";"";"-77,00";"429.071,74";""
"02.06.2025";"02.06.2025";"MCD 00978 CIRCLE K MOTORVEJSCENT";"";"-118,00";"428.953,74";""
"02.06.2025";"02.06.2025";"MCD 00975 CIRCLE K TILST";"";"-344,73";"428.609,01";""
"02.06.2025";"02.06.2025";"MCD 00977 CIRCLE K MOTORVEJSCENT";"";"-475,88";"428.133,13";""
"02.06.2025";"02.06.2025";"MCD 00976 CIRCLE K TILST";"";"-496,99";"427.636,14";""
"02.06.2025";"02.06.2025";"02000118060013005252                -SE MEDD.";"";"1.193,08";"428.829,22";""
"02.06.2025";"02.06.2025";"MCD 00986 CIRCLE K OSTED";"";"-119,80";"428.709,42";""
"02.06.2025";"02.06.2025";"MCD 00987 CIRCLE K TILST";"";"-351,49";"428.357,93";""
"02.06.2025";"02.06.2025";"MCD 00989 CIRCLE K RIBE";"";"-638,00";"427.719,93";""
"02.06.2025";"02.06.2025";"MCD 00988 DAGROFA S/ENGRO";"";"-1.703,13";"426.016,80";""
"02.06.2025";"02.06.2025";"02000118060013105259                -SE MEDD.";"";"94,06";"426.110,86";""
"02.06.2025";"02.06.2025";"MCD 00991 DAGROFA S/ENGRO";"";"-1.791,54";"424.319,32";""
"02.06.2025";"02.06.2025";"MCD 00990 DAGROFA S/ENGRO";"";"-6.297,86";"418.021,46";""
"02.06.2025";"02.06.2025";"BS TELENOR A/S";"";"-254,38";"417.767,08";""
"02.06.2025";"02.06.2025";"LS 38393 DANFOODS APS";"";"-5.335,53";"412.431,55";""
"02.06.2025";"02.06.2025";"02000118060010106251                -SE MEDD.";"";"202,97";"412.634,52";""
"02.06.2025";"02.06.2025";"MCD 00994 Storebaeltsforbindelse";"";"-230,00";"412.404,52";""
"02.06.2025";"02.06.2025";"MCD 00993 Uno-X 1977 Fabrikspark";"";"-890,35";"411.514,17";""
"02.06.2025";"02.06.2025";"MCD 00992 DAGROFA S/ENGRO";"";"-4.147,30";"407.366,87";""
"03.06.2025";"03.06.2025";"LS 38393 DANFOODS APS";"";"-9.986,14";"397.380,73";""
"03.06.2025";"03.06.2025";"MCD 00995 SumUp  *Foodtruck Fies";"";"-10,00";"397.370,73";""
"03.06.2025";"03.06.2025";"MCD 00996 BAUHAUS";"";"-558,76";"396.811,97";""
"04.06.2025";"04.06.2025";"LS 38393 DANFOODS APS";"";"-3.497,84";"393.314,13";""
"04.06.2025";"04.06.2025";"Le Gout Biltræf Hjortshøj";"";"-2.806,50";"390.507,63";""
"04.06.2025";"04.06.2025";"MCD 00998 Elektronik Lavpris";"";"-69,00";"390.438,63";""
"04.06.2025";"04.06.2025";"MCD 00999 Lunar Top-up";"";"-804,00";"389.634,63";""
"04.06.2025";"04.06.2025";"MCD 00997 DAGROFA S/ENGRO";"";"-1.816,20";"387.818,43";""
"06.06.2025";"06.06.2025";"MCD 01001 Inco CC Aarhus AS";"";"-449,64";"387.368,79";""
"06.06.2025";"06.06.2025";"MCD 01000 DAGROFA S/ENGRO";"";"-1.011,43";"386.357,36";""
"06.06.2025";"06.06.2025";"02000118060010506259                -SE MEDD.";"";"94,06";"386.451,42";""
"06.06.2025";"06.06.2025";"MCD 01007 TV2 DK* ID 202532106";"";"-179,00";"386.272,42";""
"06.06.2025";"06.06.2025";"Århus Catering fakturanr 5232";"";"-5.026,25";"381.246,17";""
"06.06.2025";"06.06.2025";"MCD 01002 CIRCLE K TILST";"";"-502,91";"380.743,26";""
"06.06.2025";"06.06.2025";"MCD 01004 Uno-X 1977 Fabrikspark";"";"-563,71";"380.179,55";""
"06.06.2025";"06.06.2025";"MCD 01006 MINA ISTANBUL KEBAB PR";"";"-5.100,00";"375.079,55";""
"06.06.2025";"06.06.2025";"MCD 01003 DAGROFA S/ENGRO";"";"-6.822,35";"368.257,20";""
"06.06.2025";"06.06.2025";"MCD 01005 MINA ISTANBUL KEBAB PR";"";"-15.300,00";"352.957,20";""
"06.06.2025";"06.06.2025";"MCD 01014 Revolut**2287*";"";"-1.000,00";"351.957,20";""
"10.06.2025";"10.06.2025";"02000118060010606256                -SE MEDD.";"";"376,24";"352.333,44";""
"10.06.2025";"10.06.2025";"MCD 01012 Inco CC Aarhus AS";"";"-149,95";"352.183,49";""
"10.06.2025";"10.06.2025";"MCD 01010 CIRCLE K MOTORVEJSCENT";"";"-158,00";"352.025,49";""
"10.06.2025";"10.06.2025";"MCD 01011 Storebaeltsforbindelse";"";"-350,00";"351.675,49";""
"10.06.2025";"10.06.2025";"MCD 01015 DAGROFA S/ENGRO";"";"-404,86";"351.270,63";""
"10.06.2025";"10.06.2025";"MCD 01016 MCDTILST";"";"-413,00";"350.857,63";""
"10.06.2025";"10.06.2025";"MCD 01013 CIRCLE K TILST";"";"-690,94";"350.166,69";""
"10.06.2025";"10.06.2025";"MCD 01009 CIRCLE K MOTORVEJSCENT";"";"-732,73";"349.433,96";""
"10.06.2025";"10.06.2025";"MCD 01008 CIRCLE K MOTORVEJSCENT";"";"-789,02";"348.644,94";""
"10.06.2025";"10.06.2025";"02000118060010706253                -SE MEDD.";"";"3.856,43";"352.501,37";""
"10.06.2025";"10.06.2025";"MCD 01021 Revolut**2287*";"";"-1.000,00";"351.501,37";""
"10.06.2025";"10.06.2025";"MCD 01017 CIRCLE K TILST";"";"-132,00";"351.369,37";""
"10.06.2025";"10.06.2025";"MCD 01018 Inco CC Aarhus AS";"";"-599,89";"350.769,48";""
"10.06.2025";"10.06.2025";"MCD 01019 DAGROFA S/ENGRO";"";"-1.734,91";"349.034,57";""
"10.06.2025";"10.06.2025";"MCD 01020 Lunar Top-up";"";"-804,00";"348.230,57";""
"10.06.2025";"10.06.2025";"MCD 01022 Lunar Top-up";"";"-854,00";"347.376,57";""
"10.06.2025";"10.06.2025";"MCD 01023 Q8 Låsby 8206";"";"-1.000,00";"346.376,57";""
"10.06.2025";"10.06.2025";"MCD 01024 DAGROFA S/ENGRO";"";"-1.708,29";"344.668,28";""
"10.06.2025";"10.06.2025";"BS AURA A/S - FIBER";"";"-299,00";"344.369,28";""
"10.06.2025";"10.06.2025";"LS 11045 OK A.M.B.A.";"";"-1.495,72";"342.873,56";""
"10.06.2025";"10.06.2025";"LS 38393 DANFOODS APS";"";"-1.428,55";"341.445,01";""
"10.06.2025";"10.06.2025";"MCD 01025 BAZAR ÅRHUS";"";"-500,00";"340.945,01";""
"10.06.2025";"10.06.2025";"MCD 01026 Lunar Top-up";"";"-1.504,00";"339.441,01";""
"10.06.2025";"10.06.2025";"LP907e175277                        -SE MEDD.";"";"74.473,81";"413.914,82";""
"10.06.2025";"10.06.2025";"MCD 01029 Revolut**2287*";"";"-2.000,00";"411.914,82";""
"11.06.2025";"11.06.2025";"LS 38393 DANFOODS APS";"";"-7.647,12";"404.267,70";""
"11.06.2025";"11.06.2025";"MCD 01028 APPLE.COM/BILL";"";"-179,00";"404.088,70";""
"11.06.2025";"11.06.2025";"MCD 01030 Revolut**2287*";"";"-2.000,00";"402.088,70";""
"11.06.2025";"11.06.2025";"MCD 01027 AARHUS BUSINESS";"";"-37,00";"402.051,70";""
"12.06.2025";"12.06.2025";"02000118060011106250                -SE MEDD.";"";"147,52";"402.199,22";""
"12.06.2025";"12.06.2025";"LS 38393 DANFOODS APS";"";"-2.199,00";"400.000,22";""
"12.06.2025";"12.06.2025";"MCD 01035 Revolut**2287*";"";"-500,00";"399.500,22";""
"12.06.2025";"12.06.2025";"MCD 01034 Revolut**2287*";"";"-2.500,00";"397.000,22";""
"12.06.2025";"12.06.2025";"MCD 01033 Uno-X 2486 Tilst";"";"-616,35";"396.383,87";""
"12.06.2025";"12.06.2025";"MCD 01031 CIRCLE K TILST";"";"-1.000,00";"395.383,87";""
"12.06.2025";"12.06.2025";"MCD 01032 DAGROFA S-ENGRO";"";"-1.246,17";"394.137,70";""
"13.06.2025";"13.06.2025";"02000118060011206257                -SE MEDD.";"";"455,45";"394.593,15";""
"13.06.2025";"13.06.2025";"LS 38393 DANFOODS APS";"";"-8.874,07";"385.719,08";""
"13.06.2025";"13.06.2025";"Johs. Sørensen & Sønner Århus A/S";"";"-494,70";"385.224,38";""
"13.06.2025";"13.06.2025";"Århus Catering 5245";"";"-6.901,25";"378.323,13";""
"13.06.2025";"13.06.2025";"Regning";"";"-1.323,75";"376.999,38";""
"13.06.2025";"13.06.2025";"MCD 01040 NETTO S@NDERVAN";"";"-45,00";"376.954,38";""
"13.06.2025";"13.06.2025";"MCD 01038 AARHUS BUSINESS";"";"-57,00";"376.897,38";""
"13.06.2025";"13.06.2025";"MCD 01037 Coop Kvickly Viby J";"";"-118,00";"376.779,38";""
"13.06.2025";"13.06.2025";"MCD 01041 Uno-X 403 Middelfart H";"";"-405,15";"376.374,23";""
"13.06.2025";"13.06.2025";"MCD 01042 CIRCLE K TILST";"";"-568,82";"375.805,41";""
"13.06.2025";"13.06.2025";"MCD 01039 KPA COMPANY APS";"";"-1.378,95";"374.426,46";""
"13.06.2025";"13.06.2025";"MCD 01036 DAGROFA S/ENGRO";"";"-4.493,84";"369.932,62";""
"16.06.2025";"16.06.2025";"02000118060011306254                -SE MEDD.";"";"89,11";"370.021,73";""
"16.06.2025";"16.06.2025";"MCD 01047 SumUp  *Foodtruck Fies";"";"-198,00";"369.823,73";""
"16.06.2025";"16.06.2025";"Sambosa";"";"-4.735,52";"365.088,21";""
"16.06.2025";"16.06.2025";"MCD 01044 CIRCLE K ORSTEDSVEJ, S";"";"-42,00";"365.046,21";""
"16.06.2025";"16.06.2025";"MCD 01043 CIRCLE K ORSTEDSVEJ, S";"";"-49,00";"364.997,21";""
"16.06.2025";"16.06.2025";"MCD 01045 MCDVEJLESYD";"";"-99,00";"364.898,21";""
"16.06.2025";"16.06.2025";"MCD 01046 DAGROFA S-ENGRO";"";"-1.860,89";"363.037,32";""
"16.06.2025";"16.06.2025";"02000118060011406251                -SE MEDD.";"";"534,65";"363.571,97";""
"16.06.2025";"16.06.2025";"MCD 01053 SINTRA 15,60 USD kurs: 649,230700";"";"-103,71";"363.468,26";""
"16.06.2025";"16.06.2025";"MCD 01051 CIRCLE K TILST";"";"-250,30";"363.217,96";""
"16.06.2025";"16.06.2025";"MCD 01052 DAGROFA S/ENGRO";"";"-310,51";"362.907,45";""
"16.06.2025";"16.06.2025";"MCD 01048 CIRCLE K TILST";"";"-332,16";"362.575,29";""
"16.06.2025";"16.06.2025";"MCD 01050 DAGROFA S-ENGRO";"";"-2.348,96";"360.226,33";""
"16.06.2025";"16.06.2025";"MCD 01049 DAGROFA S-ENGRO";"";"-2.945,73";"357.280,60";""
"16.06.2025";"16.06.2025";"Betalinger, 3 stk.";"";"-180,00";"357.100,60";""
"16.06.2025";"16.06.2025";"LS 38393 DANFOODS APS";"";"-3.396,00";"353.704,60";""
"16.06.2025";"16.06.2025";"02000118060011506258                -SE MEDD.";"";"148,52";"353.853,12";""
"16.06.2025";"16.06.2025";"MCD 00000 DAGROFA S-ENGRO";"";"227,36";"354.080,48";""
"16.06.2025";"16.06.2025";"MCD 01058 CIRCLE K LEGARDVEJ";"";"-319,00";"353.761,48";""
"16.06.2025";"16.06.2025";"MCD 01060 Q8 Holstebro 8250";"";"-333,00";"353.428,48";""
"16.06.2025";"16.06.2025";"MCD 01056 DAGROFA S-ENGRO";"";"-404,86";"353.023,62";""
"16.06.2025";"16.06.2025";"MCD 01054 Lunar Top-up";"";"-704,00";"352.319,62";""
"16.06.2025";"16.06.2025";"MCD 01055 CIRCLE K TILST";"";"-763,44";"351.556,18";""
"16.06.2025";"16.06.2025";"MCD 01059 Q8 Vissenbjerg 8102";"";"-800,00";"350.756,18";""
"16.06.2025";"16.06.2025";"MCD 01057 DAGROFA S-ENGRO";"";"-882,10";"349.874,08";""
"16.06.2025";"16.06.2025";"MCD 01061 BAUHAUS HERNING";"";"-1.868,95";"348.005,13";""
"16.06.2025";"16.06.2025";"LP9dccae455c                        -SE MEDD.";"";"11.617,79";"359.622,92";""
"17.06.2025";"17.06.2025";"MasterCard Debit genbestilling";"";"-150,00";"359.472,92";""
"17.06.2025";"17.06.2025";"LS 38393 DANFOODS APS";"";"-5.393,83";"354.079,09";""
"17.06.2025";"17.06.2025";"Overførsel                          -SE MEDD.";"";"7.389,90";"361.468,99";""
"17.06.2025";"17.06.2025";"Mina Istanbul Kebab Produktion Aps";"";"-40.031,25";"321.437,74";""
"17.06.2025";"17.06.2025";"Overførsel";"";"-31,25";"321.406,49";""
"18.06.2025";"18.06.2025";"Betalinger, 1 stk.";"";"-60,00";"321.346,49";""
"18.06.2025";"18.06.2025";"LS 38393 DANFOODS APS";"";"-2.950,96";"318.395,53";""
"18.06.2025";"18.06.2025";"Mcd 0870 DRAGOFA";"";"-2.783,00";"315.612,53";""
"18.06.2025";"18.06.2025";"Danfoods mcd 9088";"";"-3.469,00";"312.143,53";""
"18.06.2025";"18.06.2025";"MCD 01064 Megafood ApS";"";"-385,25";"311.758,28";""
"18.06.2025";"18.06.2025";"MCD 01062 BAUHAUS";"";"-684,75";"311.073,53";""
"18.06.2025";"18.06.2025";"MCD 01063 JEM & FIX TILST";"";"-887,25";"310.186,28";""
"19.06.2025";"19.06.2025";"LS 38393 DANFOODS APS";"";"-864,09";"309.322,19";""
"19.06.2025";"19.06.2025";"Distortion 2025                     -SE MEDD.";"";"5.000,00";"314.322,19";""
"19.06.2025";"19.06.2025";"MCD 01065 NVIDIA CORPORATION";"";"-179,00";"314.143,19";""
"19.06.2025";"19.06.2025";"MCD 01066 S-ENGROS SILKEB";"";"-930,29";"313.212,90";""
"19.06.2025";"19.06.2025";"Århus Catering";"";"-3.487,00";"309.725,90";""
"20.06.2025";"20.06.2025";"MCD 01069 APPLE.COM/BILL";"";"-55,00";"309.670,90";""
"20.06.2025";"20.06.2025";"MCD 01067 Inco CC Aarhus AS";"";"-1.568,83";"308.102,07";""
"20.06.2025";"20.06.2025";"MCD 01068 DAGROFA S/ENGRO";"";"-3.711,14";"304.390,93";""
"23.06.2025";"23.06.2025";"Dragofa Holst 802";"";"-2.376,33";"302.014,60";""
"23.06.2025";"23.06.2025";"MCD 01070 CIRCLE K BREGNEVEJ, SI";"";"-422,00";"301.592,60";""
"23.06.2025";"23.06.2025";"MCD 01071 OIL tank go Tilst v/AA";"";"-450,81";"301.141,79";""
"23.06.2025";"23.06.2025";"MCD 01072 DAGROFA S/ENGRO";"";"-1.316,78";"299.825,01";""
"23.06.2025";"23.06.2025";"Ls DANFOODS 677";"";"-2.458,00";"297.367,01";""
"23.06.2025";"23.06.2025";"MCD 01073 DAGROFA S-ENGRO";"";"-1.050,11";"296.316,90";""
"23.06.2025";"23.06.2025";"LS 38393 DANFOODS APS";"";"-5.312,76";"291.004,14";""
"23.06.2025";"23.06.2025";"MCD 01074 CIRCLE K LEGARDVEJ";"";"-295,65";"290.708,49";""
"23.06.2025";"23.06.2025";"LS DSNFOODS 127";"";"-1.967,00";"288.741,49";""
"24.06.2025";"24.06.2025";"LS 38393 DANFOODS APS";"";"-6.643,10";"282.098,39";""
"24.06.2025";"24.06.2025";"MCD 01075 CIRCLE K GJESING";"";"-68,50";"282.029,89";""
"24.06.2025";"24.06.2025";"MCD 01076 THANSEN GRUPPEN";"";"-1.386,45";"280.643,44";""
"25.06.2025";"25.06.2025";"Aura 9899";"";"-799,00";"279.844,44";""
"25.06.2025";"25.06.2025";"LS 11045 OK A.M.B.A.";"";"-524,10";"279.320,34";""
"25.06.2025";"25.06.2025";"Overførsel                          -SE MEDD.";"";"10.425,00";"289.745,34";""
"25.06.2025";"25.06.2025";"MCD 01077 WINDSURF 18,75 USD kurs: 651,360000";"";"-125,06";"289.620,28";""
"25.06.2025";"25.06.2025";"Larsen og Jakobsen Fakturanr. 15435";"";"-3.500,00";"286.120,28";""
"25.06.2025";"25.06.2025";"MCD 01078 Q8 Holstebro 8250";"";"-500,00";"285.620,28";""
"25.06.2025";"25.06.2025";"MCD 01079 THANSEN GRUPPEN";"";"-558,81";"285.061,47";""
"25.06.2025";"25.06.2025";"MCD 01080 Q8 Holstebro 8250";"";"-600,00";"284.461,47";""
"26.06.2025";"26.06.2025";"LS 38393 DANFOODS APS";"";"-3.690,95";"280.770,52";""
"26.06.2025";"26.06.2025";"tryg Registreringsnr.: BE26246";"";"-9.715,00";"271.055,52";""
"26.06.2025";"26.06.2025";"Facebook Ads";"";"-1.000,00";"270.055,52";""
"26.06.2025";"26.06.2025";"MCD 01082 INGO ARHUS HASLE";"";"-961,98";"269.093,54";""
"26.06.2025";"26.06.2025";"MCD 01081 DAGROFA S/ENGRO";"";"-3.643,07";"265.450,47";""
"27.06.2025";"27.06.2025";"DFIM MOTOR";"";"-1.296,00";"264.154,47";""
"27.06.2025";"27.06.2025";"LS 38393 DANFOODS APS";"";"-2.141,16";"262.013,31";""
"27.06.2025";"27.06.2025";"Silkeborg SFF  Mad & Kultur         -SE MEDD.";"";"74.080,39";"336.093,70";""
"27.06.2025";"27.06.2025";"MCD 01083 CIRCLE K TILST";"";"-382,67";"335.711,03";""
"30.06.2025";"30.06.2025";"MCD 01092 CIRCLE K TILST";"";"-49,00";"335.662,03";""
"30.06.2025";"30.06.2025";"MCD 01090 DAGROFA S/ENGRO";"";"-225,76";"335.436,27";""
"30.06.2025";"30.06.2025";"MCD 01088 Shell AALBORG";"";"-299,00";"335.137,27";""
"30.06.2025";"30.06.2025";"MCD 01089 DAGROFA S/ENGRO";"";"-523,29";"334.613,98";""
"30.06.2025";"30.06.2025";"MCD 01091 CIRCLE K TILST";"";"-662,78";"333.951,20";""
"30.06.2025";"30.06.2025";"MCD 01097 Revolut**2287*";"";"-500,00";"333.451,20";""
"30.06.2025";"30.06.2025";"02000118060012806258                -SE MEDD.";"";"188,11";"333.639,31";""
"30.06.2025";"30.06.2025";"MCD 01100 CIRCLE K MOTORVEJSCENT";"";"-0,43";"333.638,88";""
"30.06.2025";"30.06.2025";"MCD 01098 Kvickly Helsing";"";"-187,95";"333.450,93";""
"30.06.2025";"30.06.2025";"MCD 01102 CIRCLE K MOTORVEJSCENT";"";"-408,65";"333.042,28";""
"30.06.2025";"30.06.2025";"MCD 01093 CIRCLE K TILST";"";"-426,73";"332.615,55";""
"30.06.2025";"30.06.2025";"MCD 01099 OK Struer";"";"-500,00";"332.115,55";""
"30.06.2025";"30.06.2025";"MCD 01096 DAGROFA S/ENGRO";"";"-2.136,49";"329.979,06";""
"30.06.2025";"30.06.2025";"MCD 01095 DAGROFA S/ENGRO";"";"-9.778,12";"320.200,94";""
"30.06.2025";"30.06.2025";"LS 38393 DANFOODS APS";"";"-1.855,69";"318.345,25";""
"30.06.2025";"30.06.2025";"Online Banking gebyrer";"";"-736,40";"317.608,85";""
"30.06.2025";"30.06.2025";"Kundegebyr";"";"-200,00";"317.408,85";""
"30.06.2025";"30.06.2025";"OS Lønovf. - bogf. hos modtager 3";"";"-1,50";"317.407,35";""
"30.06.2025";"30.06.2025";"OS Lønovf. - træk på jeres konto 3";"";"-1,50";"317.405,85";""
"30.06.2025";"30.06.2025";"MCD 01107 F@TEX AALBORG";"";"-200,00";"317.205,85";""
"30.06.2025";"30.06.2025";"MCD 01103 Storebaeltsforbindelse";"";"-230,00";"316.975,85";""
"30.06.2025";"30.06.2025";"MCD 01109 Wolt";"";"-299,98";"316.675,87";""
"30.06.2025";"30.06.2025";"MCD 01106 Revolut**2287*";"";"-1.000,00";"315.675,87";""
"30.06.2025";"30.06.2025";"MCD 01094 Lunar Top-up";"";"-1.504,00";"314.171,87";""
"30.06.2025";"30.06.2025";"MCD 01104 CIRCLE K MOTORVEJSCENT";"";"-139,00";"314.032,87";""
"30.06.2025";"30.06.2025";"MCD 01105 CIRCLE K MOTORVEJSCENT";"";"-395,88";"313.636,99";""
"30.06.2025";"30.06.2025";"LPc9889edccb                        -SE MEDD.";"";"56.972,71";"370.609,70";""
"01.07.2025";"01.07.2025";"LS 38393 DANFOODS APS";"";"-17.389,20";"353.220,50";""
"01.07.2025";"01.07.2025";"MCD 01110 Zettle_*COFFEE   THE B";"";"-139,00";"353.081,50";""
"01.07.2025";"01.07.2025";"MCD 01087 KARROUM TRADING";"";"-176,84";"352.904,66";""
"01.07.2025";"01.07.2025";"MCD 01084 IMERCO ÅLBORG,";"";"-184,50";"352.720,16";""
"01.07.2025";"01.07.2025";"MCD 01085 F@TEX AALBORG";"";"-379,00";"352.341,16";""
"01.07.2025";"01.07.2025";"MCD 01086 DEKRA Bilsyn - Tilst";"";"-1.495,00";"350.846,16";""
"01.07.2025";"01.07.2025";"MCD 01111 Coop 365 Moelleparken";"";"-163,90";"350.682,26";""
"01.07.2025";"01.07.2025";"MCD 01108 Q8 Låsby 8206";"";"-300,00";"350.382,26";""
"02.07.2025";"02.07.2025";"BS TELENOR A/S";"";"-254,98";"350.127,28";""
"02.07.2025";"02.07.2025";"LS 38393 DANFOODS APS";"";"-666,86";"349.460,42";""
"02.07.2025";"02.07.2025";"Mina Kebab ApS, faknr 5029735";"";"-22.201,69";"327.258,73";""
"02.07.2025";"02.07.2025";"Larsen og Jakobsen Fakturanr. 15815";"";"-12.187,50";"315.071,23";""
"02.07.2025";"02.07.2025";"Helsingør Koncert Streetfoodies";"";"-7.613,75";"307.457,48";""
"02.07.2025";"02.07.2025";"churrosvogn Emmas's Ismejeri";"";"-40.000,00";"267.457,48";""
"02.07.2025";"02.07.2025";"MCD 54231 NETTO S@NDERVAN";"";"-600,00";"266.857,48";""
"03.07.2025";"03.07.2025";"MCD 01113 KARROUM TRADING";"";"-426,15";"266.431,33";""
"04.07.2025";"04.07.2025";"LS 38393 DANFOODS APS";"";"-3.192,85";"263.238,48";""
"04.07.2025";"04.07.2025";"MCD 01122 Wolt";"";"-265,00";"262.973,48";""
"04.07.2025";"04.07.2025";"MCD 01123 Max Burgers 7610002_Co";"";"-284,00";"262.689,48";""
"04.07.2025";"04.07.2025";"MCD 01117 AIRBNB * HMTAES98FF";"";"-1.682,35";"261.007,13";""
"04.07.2025";"04.07.2025";"MCD 01116 PARKMAN";"";"-131,83";"260.875,30";""
"04.07.2025";"04.07.2025";"MCD 01120 CIRCLE K TILST";"";"-202,22";"260.673,08";""
"04.07.2025";"04.07.2025";"MCD 01114 BAZAR ÅRHUS";"";"-375,00";"260.298,08";""
"04.07.2025";"04.07.2025";"MCD 01118 Coop 365 Moelleparken";"";"-531,95";"259.766,13";""
"04.07.2025";"04.07.2025";"MCD 01119 CIRCLE K TILST";"";"-614,56";"259.151,57";""
"07.07.2025";"07.07.2025";"02000118060010407251                -SE MEDD.";"";"193,07";"259.344,64";""
"07.07.2025";"07.07.2025";"MCD 01125 DAGROFA S/ENGRO";"";"-46,60";"259.298,04";""
"07.07.2025";"07.07.2025";"MCD 01129 Coop 365 Lerchesvej";"";"-67,70";"259.230,34";""
"07.07.2025";"07.07.2025";"MCD 01130 DAGROFA S/ENGRO";"";"-156,39";"259.073,95";""
"07.07.2025";"07.07.2025";"MCD 01126 CIRCLE K MOTORVEJSCENT";"";"-295,62";"258.778,33";""
"07.07.2025";"07.07.2025";"MCD 01128 DAGROFA S/ENGRO";"";"-503,11";"258.275,22";""
"07.07.2025";"07.07.2025";"MCD 01124 CIRCLE K TILST";"";"-550,13";"257.725,09";""
"07.07.2025";"07.07.2025";"MCD 01121 Uno-X 1924 Svendborg,";"";"-883,05";"256.842,04";""
"07.07.2025";"07.07.2025";"MCD 01127 DAGROFA S/ENGRO";"";"-2.179,53";"254.662,51";""
"07.07.2025";"07.07.2025";"MCD 01131 LOOMISP*Phonos lS";"";"-4.680,00";"249.982,51";""
"07.07.2025";"07.07.2025";"MCD 01134 TV2 DK* ID 204197301";"";"-179,00";"249.803,51";""
"07.07.2025";"07.07.2025";"MCD 01135 AIRBNB * HMANZERE8A";"";"-740,71";"249.062,80";""
"07.07.2025";"07.07.2025";"MCD 01133 Coop 365 Lerchesvej";"";"-141,50";"248.921,30";""
"07.07.2025";"07.07.2025";"MCD 01136 NETTO S@NDERVAN";"";"-600,00";"248.321,30";""
"07.07.2025";"07.07.2025";"MCD 01132 DAGROFA S/ENGRO";"";"-894,46";"247.426,84";""
"07.07.2025";"07.07.2025";"MCD 01145 Wolt";"";"-148,40";"247.278,44";""
"07.07.2025";"07.07.2025";"Stripe Technology Eu                -SE MEDD.";"";"9.163,00";"256.441,44";""
"07.07.2025";"07.07.2025";"Ls DANFOODS 6778";"";"-4.783,00";"251.658,44";""
"07.07.2025";"07.07.2025";"MCD 01143 CIRCLE K RONDE";"";"-51,00";"251.607,44";""
"07.07.2025";"07.07.2025";"MCD 01140 LIDL132ARHUSVIBYJ";"";"-137,75";"251.469,69";""
"07.07.2025";"07.07.2025";"MCD 01144 Storebaeltsforbindelse";"";"-230,00";"251.239,69";""
"07.07.2025";"07.07.2025";"MCD 01138 C Nobel Toemmerhandel";"";"-245,00";"250.994,69";""
"07.07.2025";"07.07.2025";"MCD 01139 DAGROFA S/ENGRO";"";"-338,96";"250.655,73";""
"07.07.2025";"07.07.2025";"MCD 01141 NETTO S@NDERVAN";"";"-600,00";"250.055,73";""
"07.07.2025";"07.07.2025";"MCD 01137 DAGROFA S/ENGRO";"";"-791,51";"249.264,22";""
"07.07.2025";"07.07.2025";"MCD 01142 CIRCLE K RINGSTEDV.ROS";"";"-875,40";"248.388,82";""
"07.07.2025";"07.07.2025";"LPcd14e402c7                        -SE MEDD.";"";"89.963,13";"338.351,95";""
"08.07.2025";"08.07.2025";"LS 38393 DANFOODS APS";"";"-7.619,99";"330.731,96";""
"08.07.2025";"08.07.2025";"MCD 01151 WINDSURF 10,00 USD kurs: 636,700000";"";"-65,20";"330.666,76";""
"08.07.2025";"08.07.2025";"MCD 01148 GLITTER BRUUNS";"";"-74,84";"330.591,92";""
"08.07.2025";"08.07.2025";"MCD 01150 NETTO H@JBJERG";"";"-192,00";"330.399,92";""
"08.07.2025";"08.07.2025";"MCD 01146 CIRCLE K TILST";"";"-250,37";"330.149,55";""
"08.07.2025";"08.07.2025";"MCD 01149 J[GERGÅRDSGADE";"";"-1.373,00";"328.776,55";""
"08.07.2025";"08.07.2025";"MCD 01147 LOOMISP*Phonos lS";"";"-1.480,00";"327.296,55";""
"09.07.2025";"09.07.2025";"LS 38393 DANFOODS APS";"";"-540,59";"326.755,96";""
"09.07.2025";"09.07.2025";"MCD 01153 Lunar Top-up";"";"-679,00";"326.076,96";""
"09.07.2025";"09.07.2025";"MCD 01152 NETTO S@NDERVAN";"";"-181,45";"325.895,51";""
"10.07.2025";"10.07.2025";"BS AURA A/S - FIBER";"";"-299,00";"325.596,51";""
"10.07.2025";"10.07.2025";"LS 11045 OK A.M.B.A.";"";"-1.097,84";"324.498,67";""
"10.07.2025";"10.07.2025";"LS 38393 DANFOODS APS";"";"-8.334,11";"316.164,56";""
"10.07.2025";"10.07.2025";"LP7aa456e65a                        -SE MEDD.";"";"87,31";"316.251,87";""
"10.07.2025";"10.07.2025";"MCD 01156 NETTO S@NDERVAN";"";"-45,00";"316.206,87";""
"10.07.2025";"10.07.2025";"MCD 01155 Refako Aps";"";"-67,20";"316.139,67";""
"10.07.2025";"10.07.2025";"MCD 01157 NETTO S@NDERVAN";"";"-600,00";"315.539,67";""
"10.07.2025";"10.07.2025";"MCD 01154 THANSEN GRUPPEN";"";"-1.787,68";"313.751,99";""
"10.07.2025";"10.07.2025";"MCD 01160 Mol*Maxima Kitchen Equ 279,98 EUR kurs: 746,199700";"";"-2.113,65";"311.638,34";""
"10.07.2025";"10.07.2025";"Vorbasse 2015690, vogn 1";"";"-12.500,00";"299.138,34";""
"10.07.2025";"10.07.2025";"Vorbasse 2015688, vogn 1";"";"-12.500,00";"286.638,34";""
"10.07.2025";"10.07.2025";"Århus Catering faktura 5301";"";"-3.731,25";"282.907,09";""
"10.07.2025";"10.07.2025";"tallshiprace esbjerg pladser";"";"-75.000,00";"207.907,09";""
"11.07.2025";"11.07.2025";"Hogager Marked Faktura 2025186";"";"-4.750,00";"203.157,09";""
"11.07.2025";"11.07.2025";"Hogager Marked faktura 2025119";"";"-5.000,00";"198.157,09";""
"11.07.2025";"11.07.2025";"LS 28924 VISMA E-CONOMIC A/S";"";"-1.308,75";"196.848,34";""
"11.07.2025";"11.07.2025";"BW STREET FOOD APS                  -SE MEDD.";"";"-55.000,00";"141.848,34";""
"11.07.2025";"11.07.2025";"MCD 01158 APPLE.COM/BILL";"";"-179,00";"141.669,34";""
"11.07.2025";"11.07.2025";"MCD 01161 Wolt";"";"-319,06";"141.350,28";""
"11.07.2025";"11.07.2025";"MCD 01159 Lunar Top-up";"";"-2.004,00";"139.346,28";""
"14.07.2025";"14.07.2025";"MCD 01163 Refako Aps";"";"-14,60";"139.331,68";""
"14.07.2025";"14.07.2025";"MCD 01167 NETTO TILST";"";"-263,30";"139.068,38";""
"14.07.2025";"14.07.2025";"MCD 01166 Inco CC Aarhus AS";"";"-448,65";"138.619,73";""
"14.07.2025";"14.07.2025";"MCD 01165 NETTO S@NDERVAN";"";"-600,00";"138.019,73";""
"14.07.2025";"14.07.2025";"MCD 01162 Refako Aps";"";"-1.036,00";"136.983,73";""
"14.07.2025";"14.07.2025";"MCD 01164 Refako Aps";"";"-1.164,60";"135.819,13";""
"14.07.2025";"14.07.2025";"MCD 83933 WINDSURF 10,00 USD kurs: 639,800000";"";"-65,52";"135.753,61";""
"14.07.2025";"14.07.2025";"MCD 01172 Wolt";"";"-184,29";"135.569,32";""
"14.07.2025";"14.07.2025";"MCD 01171 Wolt";"";"-462,00";"135.107,32";""
"14.07.2025";"14.07.2025";"MCD 01173 Revolut**2287*";"";"-1.000,00";"134.107,32";""
"14.07.2025";"14.07.2025";"MCD 01168 Q8 Viby J 8111";"";"-170,00";"133.937,32";""
"14.07.2025";"14.07.2025";"MCD 01176 CIRCLE K TILST";"";"-197,66";"133.739,66";""
"14.07.2025";"14.07.2025";"MCD 01174 SHAWARMA 2 I/S";"";"-610,79";"133.128,87";""
"14.07.2025";"14.07.2025";"MCD 01180 SumUp  *FFOOD";"";"-146,00";"132.982,87";""
"14.07.2025";"14.07.2025";"Køb af Friture brugt";"";"-11.500,00";"121.482,87";""
"14.07.2025";"14.07.2025";"MCD 01181 REMA 1000 AARHU";"";"-12,00";"121.470,87";""
"14.07.2025";"14.07.2025";"MCD 01177 CIRCLE K ARHUS V";"";"-70,00";"121.400,87";""
"14.07.2025";"14.07.2025";"MCD 01178 CIRCLE K SKANDERBORGVE";"";"-111,00";"121.289,87";""
"14.07.2025";"14.07.2025";"MCD 01179 BAUHAUS";"";"-242,91";"121.046,96";""
"14.07.2025";"14.07.2025";"MCD 01170 Lunar Top-up";"";"-754,00";"120.292,96";""
"14.07.2025";"14.07.2025";"MCD 01182 OK DB Sabro";"";"-837,57";"119.455,39";""
"14.07.2025";"14.07.2025";"MCD 01175 Lunar Top-up";"";"-1.604,00";"117.851,39";""
"15.07.2025";"15.07.2025";"LS 38393 DANFOODS APS";"";"-7.995,57";"109.855,82";""
"15.07.2025";"15.07.2025";"MCD 01191 SINTRA 15,60 USD kurs: 639,679400";"";"-102,18";"109.753,64";""
"15.07.2025";"15.07.2025";"MCD 01190 3037 Burger King Trojb";"";"-120,00";"109.633,64";""
"15.07.2025";"15.07.2025";"GGM GASTRO #25DKS0027957";"";"-2.901,80";"106.731,84";""
"15.07.2025";"15.07.2025";"MCD 01188 PHI LONG";"";"-60,00";"106.671,84";""
"15.07.2025";"15.07.2025";"MCD 01189 L@VBJERG SUPERM";"";"-112,40";"106.559,44";""
"15.07.2025";"15.07.2025";"MCD 01187 GEJSER STORCE";"";"-248,95";"106.310,49";""
"15.07.2025";"15.07.2025";"MCD 01183 BREMSEGÅRDEN I";"";"-350,00";"105.960,49";""
"15.07.2025";"15.07.2025";"MCD 01186 BAUHAUS";"";"-630,00";"105.330,49";""
"15.07.2025";"15.07.2025";"MCD 01185 JYSK TILST D006";"";"-1.040,00";"104.290,49";""
"15.07.2025";"15.07.2025";"MCD 01184 DAGROFA S/ENGRO";"";"-6.457,35";"97.833,14";""
"15.07.2025";"15.07.2025";"Samsø Festival forening";"";"-16.100,00";"81.733,14";""
"15.07.2025";"15.07.2025";"Overførsel";"";"-31,25";"81.701,89";""
"16.07.2025";"16.07.2025";"LS 38393 DANFOODS APS";"";"-4.878,50";"76.823,39";""
"16.07.2025";"16.07.2025";"MCD 01198 proshop.dk";"";"-1.787,00";"75.036,39";""
"16.07.2025";"16.07.2025";"MCD 01192 CIRCLE K SILKEBORGVEJ,";"";"-112,00";"74.924,39";""
"16.07.2025";"16.07.2025";"MCD 01194 CIRCLE K TILST";"";"-364,57";"74.559,82";""
"16.07.2025";"16.07.2025";"MCD 01193 CIRCLE K TILST";"";"-453,04";"74.106,78";""
"16.07.2025";"16.07.2025";"MCD 01196 BAZAR ÅRHUS";"";"-860,00";"73.246,78";""
"16.07.2025";"16.07.2025";"MCD 01195 DAGROFA S/ENGRO";"";"-1.741,02";"71.505,76";""
"16.07.2025";"16.07.2025";"MCD 01197 DAGROFA S/ENGRO";"";"-3.529,10";"67.976,66";""
"17.07.2025";"17.07.2025";"LS 38393 DANFOODS APS";"";"-4.483,23";"63.493,43";""
"17.07.2025";"17.07.2025";"Mina Kebab ApS, faknr372481";"";"-55.651,82";"7.841,61";""
"17.07.2025";"17.07.2025";"LPbcffe96e12                        -SE MEDD.";"";"22.869,84";"30.711,45";""
"17.07.2025";"17.07.2025";"Faktura 2025-001                    -SE MEDD.";"";"22.000,00";"52.711,45";""
"17.07.2025";"17.07.2025";"MCD 01199 BURGER KING VIB";"";"-249,00";"52.462,45";""
"17.07.2025";"17.07.2025";"MCD 01200 CIRCLE K RECHARGE CITY";"";"-585,20";"51.877,25";""
"17.07.2025";"17.07.2025";"MCD 01201 MAXI ZOO DK 310";"";"-809,61";"51.067,64";""
"18.07.2025";"18.07.2025";"LS 38393 DANFOODS APS";"";"-1.088,78";"49.978,86";""
"18.07.2025";"18.07.2025";"LP389e08af8d                        -SE MEDD.";"";"66.300,41";"116.279,27";""
"18.07.2025";"18.07.2025";"MCD 01203 SAMS@ FESTIVAL";"";"-35,00";"116.244,27";""
"18.07.2025";"18.07.2025";"MCD 01204 SAMS@ FESTIVAL";"";"-105,00";"116.139,27";""
"18.07.2025";"18.07.2025";"MCD 01202 DAGROFA S/ENGRO";"";"-459,09";"115.680,18";""
"21.07.2025";"21.07.2025";"MCD 01207 NVIDIA CORPORATION";"";"-179,00";"115.501,18";""
"21.07.2025";"21.07.2025";"MCD 01205 CIRCLE K TILST";"";"-199,00";"115.302,18";""
"21.07.2025";"21.07.2025";"MCD 01208 Q8 Billund 8172";"";"-256,00";"115.046,18";""
"21.07.2025";"21.07.2025";"MCD 01206 DAGROFA S/ENGRO";"";"-2.056,43";"112.989,75";""
"21.07.2025";"21.07.2025";"02000118060011907255                -SE MEDD.";"";"5.014,86";"118.004,61";""
"21.07.2025";"21.07.2025";"MCD 87058 LOOMISP*Foodtruck Fies";"";"-5,00";"117.999,61";""
"21.07.2025";"21.07.2025";"MCD 01213 WINDSURF 10,00 USD kurs: 644,700000";"";"-66,02";"117.933,59";""
"21.07.2025";"21.07.2025";"MCD 01215 SAMS@ FESTIVAL";"";"-70,00";"117.863,59";""
"21.07.2025";"21.07.2025";"MCD 01214 SAMS@ FESTIVAL";"";"-90,00";"117.773,59";""
"21.07.2025";"21.07.2025";"MCD 01216 NETTO TILST";"";"-232,50";"117.541,09";""
"21.07.2025";"21.07.2025";"MCD 01209 CIRCLE K TILST";"";"-334,00";"117.207,09";""
"21.07.2025";"21.07.2025";"MCD 01210 OK SB Vorbasse";"";"-350,68";"116.856,41";""
"21.07.2025";"21.07.2025";"MCD 01211 OK SB Vorbasse";"";"-426,34";"116.430,07";""
"21.07.2025";"21.07.2025";"MCD 01217 NETTO TILST";"";"-600,00";"115.830,07";""
"21.07.2025";"21.07.2025";"MCD 01212 DAGROFA S/ENGRO";"";"-1.779,05";"114.051,02";""
"21.07.2025";"21.07.2025";"MCD 01220 APPLE.COM/BILL";"";"-55,00";"113.996,02";""
"21.07.2025";"21.07.2025";"MCD 01221 Sunset-Boulevard RDB";"";"-75,90";"113.920,12";""
"21.07.2025";"21.07.2025";"MCD 01223 CIRCLE K TILST";"";"-938,01";"112.982,11";""
"21.07.2025";"21.07.2025";"LP96f06ae7d7                        -SE MEDD.";"";"164.094,65";"277.076,76";""
"22.07.2025";"22.07.2025";"LS 38393 DANFOODS APS";"";"-11.243,66";"265.833,10";""
"22.07.2025";"22.07.2025";"Collectia Parkeringsbøde";"";"-2.236,50";"263.596,60";""
"22.07.2025";"22.07.2025";"Århus Catering fakturanr 5319";"";"-5.651,00";"257.945,60";""
"22.07.2025";"22.07.2025";"J.S";"";"-994,31";"256.951,29";""
"22.07.2025";"22.07.2025";"MCD 01227 God Sandwich";"";"-21,81";"256.929,48";""
"22.07.2025";"22.07.2025";"MCD 01226 God Sandwich";"";"-75,83";"256.853,65";""
"22.07.2025";"22.07.2025";"MCD 01222 BURGER KING - T";"";"-156,00";"256.697,65";""
"22.07.2025";"22.07.2025";"MCD 01230 KARROUM TRADING";"";"-176,84";"256.520,81";""
"22.07.2025";"22.07.2025";"MCD 01231 NETTO S@NDERVAN";"";"-238,45";"256.282,36";""
"22.07.2025";"22.07.2025";"MCD 01233 CIRCLE K RONDE";"";"-334,97";"255.947,39";""
"22.07.2025";"22.07.2025";"MCD 01229 NETTO TILST";"";"-505,50";"255.441,89";""
"22.07.2025";"22.07.2025";"MCD 01232 NETTO S@NDERVAN";"";"-600,00";"254.841,89";""
"22.07.2025";"22.07.2025";"MCD 01225 DAGROFA S/ENGRO";"";"-1.437,83";"253.404,06";""
"22.07.2025";"22.07.2025";"MCD 01224 DAGROFA S/ENGRO";"";"-5.749,76";"247.654,30";""
"23.07.2025";"23.07.2025";"02000118060012207255                -SE MEDD.";"";"386,14";"248.040,44";""
"23.07.2025";"23.07.2025";"LP687261548f                        -SE MEDD.";"";"14.718,07";"262.758,51";""
"23.07.2025";"23.07.2025";"LPb5ed66f7ff                        -SE MEDD.";"";"41.915,57";"304.674,08";""
"23.07.2025";"23.07.2025";"MCD 01238 NETTO S@NDERVAN";"";"-120,00";"304.554,08";""
"23.07.2025";"23.07.2025";"MCD 01237 Coop Kvickly Viby J";"";"-150,85";"304.403,23";""
"23.07.2025";"23.07.2025";"MCD 01241 NETTO S@NDERVAN";"";"-184,35";"304.218,88";""
"23.07.2025";"23.07.2025";"MCD 01236 Q8 Suldrup 8103";"";"-600,00";"303.618,88";""
"23.07.2025";"23.07.2025";"MCD 01239 NETTO S@NDERVAN";"";"-600,00";"303.018,88";""
"23.07.2025";"23.07.2025";"MCD 01240 DAGROFA S/ENGRO";"";"-806,82";"302.212,06";""
"23.07.2025";"23.07.2025";"MCD 01234 Inco CC Aarhus AS";"";"-1.083,37";"301.128,69";""
"24.07.2025";"24.07.2025";"02000118060012307252                -SE MEDD.";"";"74,26";"301.202,95";""
"24.07.2025";"24.07.2025";"LS 38393 DANFOODS APS";"";"-5.783,45";"295.419,50";""
"24.07.2025";"24.07.2025";"MCD 01247 Revolut**2287*";"";"-500,00";"294.919,50";""
"24.07.2025";"24.07.2025";"MCD 01246 SumUp  *Foodtruck Fies";"";"-8,00";"294.911,50";""
"24.07.2025";"24.07.2025";"MCD 01245 Slice";"";"-230,00";"294.681,50";""
"24.07.2025";"24.07.2025";"LPfd8bfd62e7                        -SE MEDD.";"";"37.135,57";"331.817,07";""
"24.07.2025";"24.07.2025";"MCD 01244 HARALD NYBORG -";"";"-5,00";"331.812,07";""
"24.07.2025";"24.07.2025";"MCD 01235 BURGER KING VIB";"";"-243,00";"331.569,07";""
"24.07.2025";"24.07.2025";"MCD 01243 HARALD NYBORG -";"";"-1.749,35";"329.819,72";""
"25.07.2025";"25.07.2025";"02000118060012407259                -SE MEDD.";"";"84,16";"329.903,88";""
"25.07.2025";"25.07.2025";"LS 38393 DANFOODS APS";"";"-1.569,16";"328.334,72";""
"25.07.2025";"25.07.2025";"MCD 01253 JOE  THE JUICE A/S";"";"-54,00";"328.280,72";""
"25.07.2025";"25.07.2025";"MCD 01242 CIRCLE K TILST";"";"-154,00";"328.126,72";""
"25.07.2025";"25.07.2025";"MCD 01251 WINDSURF 18,75 USD kurs: 637,440000";"";"-122,39";"328.004,33";""
"25.07.2025";"25.07.2025";"MCD 01228 BERLIN GEMUSE DONER";"";"-225,00";"327.779,33";""
"25.07.2025";"25.07.2025";"MCD 01256 Revolut**2287*";"";"-500,00";"327.279,33";""
"25.07.2025";"25.07.2025";"LPcc4fc1c39f                        -SE MEDD.";"";"39.869,87";"367.149,20";""
"25.07.2025";"25.07.2025";"MCD 01255 REMA 1000 BRABR";"";"-83,75";"367.065,45";""
"25.07.2025";"25.07.2025";"MCD 01250 HARALD NYBORG -";"";"-96,00";"366.969,45";""
"25.07.2025";"25.07.2025";"MCD 01249 Q8 Viby J 8111";"";"-149,00";"366.820,45";""
"25.07.2025";"25.07.2025";"MCD 01254 Shawarma Mesteren";"";"-270,00";"366.550,45";""
"25.07.2025";"25.07.2025";"MCD 01248 CIRCLE K TILST";"";"-329,71";"366.220,74";""
"25.07.2025";"25.07.2025";"MCD 01252 MAXI ZOO DK 310";"";"-332,90";"365.887,84";""
"28.07.2025";"28.07.2025";"MCD 01260 WASABI SUSHI &";"";"-60,00";"365.827,84";""
"28.07.2025";"28.07.2025";"MCD 01258 Slice";"";"-110,00";"365.717,84";""
"28.07.2025";"28.07.2025";"MCD 01259 DAGROFA S/ENGRO";"";"-951,79";"364.766,05";""
"28.07.2025";"28.07.2025";"MCD 01257 DAGROFA S/ENGRO";"";"-2.390,46";"362.375,59";""
"28.07.2025";"28.07.2025";"02000118060012607253                -SE MEDD.";"";"5.528,72";"367.904,31";""
"28.07.2025";"28.07.2025";"MCD 01261 Wolt";"";"-299,98";"367.604,33";""
"28.07.2025";"28.07.2025";"Mobilepay overførsel flytterengørin";"";"-5.584,00";"362.020,33";""
"28.07.2025";"28.07.2025";"Freeezy Gastro -149,64 EUR kurs: 748,591000";"";"-1.120,19";"360.900,14";""
"28.07.2025";"28.07.2025";"LP265c340bc1                        -SE MEDD.";"";"223,12";"361.123,26";""
"28.07.2025";"28.07.2025";"MCD 01263 Inco CC Aarhus AS";"";"-120,92";"361.002,34";""
"28.07.2025";"28.07.2025";"MCD 01262 Inco CC Aarhus AS";"";"-2.049,99";"358.952,35";""
"28.07.2025";"28.07.2025";"LP4a16a8d2da                        -SE MEDD.";"";"33.905,85";"392.858,20";""
"28.07.2025";"28.07.2025";"Køb af Gasgrill";"";"-20.000,00";"372.858,20";""
"29.07.2025";"29.07.2025";"LS 38393 DANFOODS APS";"";"-5.305,35";"367.552,85";""
"29.07.2025";"29.07.2025";"MCD 01268 ZETA - JACE AI 39,10 USD kurs: 637,851600";"";"-255,39";"367.297,46";""
"29.07.2025";"29.07.2025";"MCD 01264 Revolut**2287*";"";"-2.000,00";"365.297,46";""
"29.07.2025";"29.07.2025";"MCD 01269 Revolut**2287*";"";"-3.000,00";"362.297,46";""
"29.07.2025";"29.07.2025";"MCD 01270 Revolut**2287*";"";"-500,00";"361.797,46";""
"29.07.2025";"29.07.2025";"LP7884f25c4a                        -SE MEDD.";"";"169,77";"361.967,23";""
"29.07.2025";"29.07.2025";"MCD 01265 Refako Aps";"";"-1.201,20";"360.766,03";""
"30.07.2025";"30.07.2025";"SummerSounds Hol.                   -SE MEDD.";"";"44.430,40";"405.196,43";""
"30.07.2025";"30.07.2025";"LPb14a551969                        -SE MEDD.";"";"388,04";"405.584,47";""
"30.07.2025";"30.07.2025";"MCD 01274 GOOGLE *Google Play Ap";"";"-55,00";"405.529,47";""
"30.07.2025";"30.07.2025";"MCD 01273 BILKA TILST";"";"-132,95";"405.396,52";""
"30.07.2025";"30.07.2025";"MCD 01271 CIRCLE K HORSENSVEJ, V";"";"-500,09";"404.896,43";""
"30.07.2025";"30.07.2025";"MCD 01272 DAGROFA S/ENGRO";"";"-5.664,18";"399.232,25";""
"31.07.2025";"31.07.2025";"Kundegebyr";"";"-200,00";"399.032,25";""
"31.07.2025";"31.07.2025";"LS 38393 DANFOODS APS";"";"-3.660,86";"395.371,39";""
"31.07.2025";"31.07.2025";"MCD 01275 JEM & FIX TILST";"";"-114,00";"395.257,39";""
"31.07.2025";"31.07.2025";"MCD 01281 KARROUM TRADING";"";"-244,36";"395.013,03";""
"31.07.2025";"31.07.2025";"MCD 01282 LOOMISP*Viking Pizza-1";"";"-265,00";"394.748,03";""
"31.07.2025";"31.07.2025";"MCD 01277 BAZAR ÅRHUS";"";"-350,00";"394.398,03";""
"31.07.2025";"31.07.2025";"MCD 01280 AL SAFADI";"";"-490,00";"393.908,03";""
"31.07.2025";"31.07.2025";"MCD 01278 CIRCLE K TILST";"";"-554,02";"393.354,01";""
"31.07.2025";"31.07.2025";"MCD 01279 CIRCLE K TILST";"";"-835,52";"392.518,49";""
"31.07.2025";"31.07.2025";"MCD 01283 MENY VILDBJERG";"";"-2.650,00";"389.868,49";""
"31.07.2025";"31.07.2025";"MCD 01276 DAGROFA S/ENGRO";"";"-3.352,75";"386.515,74";""
"01.08.2025";"01.08.2025";"02000118060013107257                -SE MEDD.";"";"89,11";"386.604,85";""
"01.08.2025";"01.08.2025";"BS TELENOR A/S";"";"-253,18";"386.351,67";""
"01.08.2025";"01.08.2025";"LS 38393 DANFOODS APS";"";"-1.949,16";"384.402,51";""
"01.08.2025";"01.08.2025";"MCD 01287 Revolut**2287*";"";"-500,00";"383.902,51";""
"01.08.2025";"01.08.2025";"LP65350c5f05                        -SE MEDD.";"";"30.417,64";"414.320,15";""
"01.08.2025";"01.08.2025";"Foreningen Klostermærken 2 biler";"";"-12.000,00";"402.320,15";""
"01.08.2025";"01.08.2025";"MCD 01285 MENY VILDBJERG";"";"-37,90";"402.282,25";""
"01.08.2025";"01.08.2025";"MCD 01286 MENY VILDBJERG";"";"-100,00";"402.182,25";""
"01.08.2025";"01.08.2025";"MCD 01284 MENY VILDBJERG";"";"-151,90";"402.030,35";""
"04.08.2025";"04.08.2025";"02000118060010108259                -SE MEDD.";"";"277,22";"402.307,57";""
"04.08.2025";"04.08.2025";"MCD 01293 PARKMAN";"";"-430,95";"401.876,62";""
"04.08.2025";"04.08.2025";"MCD 01291 Kjers Broed ApS";"";"-76,00";"401.800,62";""
"04.08.2025";"04.08.2025";"MCD 01290 Uno-X 1911 Tjoerring";"";"-251,81";"401.548,81";""
"04.08.2025";"04.08.2025";"MCD 01294 Syriens Mad";"";"-280,50";"401.268,31";""
"04.08.2025";"04.08.2025";"MCD 01292 MENY VILDBJERG";"";"-452,95";"400.815,36";""
"04.08.2025";"04.08.2025";"MCD 01295 OK Ikast 958";"";"-549,91";"400.265,45";""
"04.08.2025";"04.08.2025";"MCD 01288 CIRCLE K TILST";"";"-700,94";"399.564,51";""
"04.08.2025";"04.08.2025";"MCD 01289 DAGROFA S/ENGRO";"";"-2.742,46";"396.822,05";""
"04.08.2025";"04.08.2025";"02000118060010208256                -SE MEDD.";"";"460,40";"397.282,45";""
"04.08.2025";"04.08.2025";"MCD 01302 MENY VILDBJERG";"";"-594,00";"396.688,45";""
"04.08.2025";"04.08.2025";"MCD 01296 DAGROFA S/ENGRO";"";"-2.123,60";"394.564,85";""
"04.08.2025";"04.08.2025";"LS 38393 DANFOODS APS";"";"-11.938,44";"382.626,41";""
"04.08.2025";"04.08.2025";"02000118060010308253                -SE MEDD.";"";"138,61";"382.765,02";""
"04.08.2025";"04.08.2025";"MCD 01305 1-2-3 TIRSTRUP";"";"-216,25";"382.548,77";""
"04.08.2025";"04.08.2025";"MCD 01304 DAGROFA S/ENGRO";"";"-225,76";"382.323,01";""
"04.08.2025";"04.08.2025";"MCD 01303 DAGROFA S/ENGRO";"";"-1.278,34";"381.044,67";""
"04.08.2025";"04.08.2025";"LPc14e8527bb                        -SE MEDD.";"";"88.363,05";"469.407,72";""
"05.08.2025";"05.08.2025";"LS 38393 DANFOODS APS";"";"-21.472,08";"447.935,64";""
"05.08.2025";"05.08.2025";"MCD 01309 TV2 DK* ID 205926557";"";"-179,00";"447.756,64";""
"05.08.2025";"05.08.2025";"MCD 01310 KULTURPRODUKTIO";"";"-231,00";"447.525,64";""
"05.08.2025";"05.08.2025";"MCD 01311 Revolut**2287*";"";"-500,00";"447.025,64";""
"05.08.2025";"05.08.2025";"MCD 01306 CIRCLE K TILST";"";"-920,60";"446.105,04";""
"05.08.2025";"05.08.2025";"MCD 01307 DAGROFA S/ENGRO";"";"-5.173,37";"440.931,67";""
"06.08.2025";"06.08.2025";"LS 15741 DAGROFA FOODSERVICE A/S";"";"-1.036,44";"439.895,23";""
"06.08.2025";"06.08.2025";"LS 38393 DANFOODS APS";"";"-11.913,11";"427.982,12";""
"06.08.2025";"06.08.2025";"MCD 01308 AIRBNB * HM4BX88NDX";"";"-2.057,65";"425.924,47";""
"06.08.2025";"06.08.2025";"MCD 01316 Q8 Kolding Nord";"";"-5,00";"425.919,47";""
"06.08.2025";"06.08.2025";"MCD 01319 CIRCLE K TILST";"";"-101,00";"425.818,47";""
"06.08.2025";"06.08.2025";"MCD 01320 CIRCLE K MOTORVEJSCENT";"";"-250,30";"425.568,17";""
"06.08.2025";"06.08.2025";"MCD 01317 CIRCLE K RANDERSVEJ, A";"";"-279,69";"425.288,48";""
"06.08.2025";"06.08.2025";"MCD 01315 CIRCLE K TILST";"";"-602,41";"424.686,07";""
"06.08.2025";"06.08.2025";"MCD 01313 BAZAR ÅRHUS";"";"-700,00";"423.986,07";""
"06.08.2025";"06.08.2025";"MCD 01318 CIRCLE K TILST";"";"-702,43";"423.283,64";""
"06.08.2025";"06.08.2025";"MCD 01314 CIRCLE K TILST";"";"-803,34";"422.480,30";""
"06.08.2025";"06.08.2025";"MCD 01312 Inco CC Aarhus AS";"";"-1.422,14";"421.058,16";""
"07.08.2025";"07.08.2025";"LS 38393 DANFOODS APS";"";"-675,00";"420.383,16";""
"07.08.2025";"07.08.2025";"MCD 01326 Revolut**2287*";"";"-5.000,00";"415.383,16";""
"07.08.2025";"07.08.2025";"LP3c4117e97d                        -SE MEDD.";"";"11.434,42";"426.817,58";""
"07.08.2025";"07.08.2025";"MCD 01323 CIRCLE K SKANDERBORGVE";"";"-256,60";"426.560,98";""
"07.08.2025";"07.08.2025";"MCD 01322 CIRCLE K TILST";"";"-350,35";"426.210,63";""
"07.08.2025";"07.08.2025";"MCD 01327 CIRCLE K SILKEBORGVEJ,";"";"-450,11";"425.760,52";""
"07.08.2025";"07.08.2025";"MCD 01321 CIRCLE K TILST";"";"-549,31";"425.211,21";""
"07.08.2025";"07.08.2025";"MCD 01325 DAGROFA S/ENGRO";"";"-1.394,37";"423.816,84";""
"07.08.2025";"07.08.2025";"MCD 01324 DAGROFA S/ENGRO";"";"-2.669,15";"421.147,69";""
"08.08.2025";"08.08.2025";"02000118060010708251                -SE MEDD.";"";"74,26";"421.221,95";""
"08.08.2025";"08.08.2025";"LS 38393 DANFOODS APS";"";"-1.773,13";"419.448,82";""
"08.08.2025";"08.08.2025";"LP3ab76d4aa8                        -SE MEDD.";"";"24.228,44";"443.677,26";""
"08.08.2025";"08.08.2025";"MCD 01329 DAGROFA S/ENGRO";"";"-96,74";"443.580,52";""
"08.08.2025";"08.08.2025";"MCD 01332 CIRCLE K SILKEBORGVEJ,";"";"-319,00";"443.261,52";""
"08.08.2025";"08.08.2025";"MCD 01330 SAM'S";"";"-375,00";"442.886,52";""
"08.08.2025";"08.08.2025";"MCD 01331 SAM'S";"";"-450,00";"442.436,52";""
"08.08.2025";"08.08.2025";"MCD 01328 CIRCLE K TILST";"";"-452,78";"441.983,74";""
"11.08.2025";"11.08.2025";"Aalborg Karneval                    -SE MEDD.";"";"848,75";"442.832,49";""
"11.08.2025";"11.08.2025";"MCD 01334 Revolut**3612*";"";"-5.000,00";"437.832,49";""
"11.08.2025";"11.08.2025";"MCD 01333 CIRCLE K TILST";"";"-268,40";"437.564,09";""
"11.08.2025";"11.08.2025";"02000118060010908255                -SE MEDD.";"";"197,02";"437.761,11";""
"11.08.2025";"11.08.2025";"MCD 01335 CIRCLE K SILKEBORGVEJ,";"";"-382,00";"437.379,11";""
"11.08.2025";"11.08.2025";"MCD 01339 Revolut**3612*";"";"-1.000,00";"436.379,11";""
"11.08.2025";"11.08.2025";"02000118060011008251                -SE MEDD.";"";"282,18";"436.661,29";""
"11.08.2025";"11.08.2025";"BS AURA A/S - FIBER";"";"-299,00";"436.362,29";""
"11.08.2025";"11.08.2025";"LS 11045 OK A.M.B.A.";"";"-203,16";"436.159,13";""
"11.08.2025";"11.08.2025";"LS 15741 DAGROFA FOODSERVICE A/S";"";"-6.185,53";"429.973,60";""
